Length 8, number of unique variants is 518.
ctctcttt	[ctctcttt,ctctcttt,ctctcttt,ctctcttt]
ctrclcll	[ctlcrcrr,crctlcll,ctrclcll,clctrcrr]
ctctcttc	[cttctctc,ctctcttc,cttctctc,ctctcttc]
ctcttrcr	[cttlctcr,ctcttlcl,cttrctcl,ctcttrcr]
crccrcrc	[clclcclc,clcclclc,crcrccrc,crccrcrc]
ctctcttr	[ctctcttl,ctctcttr,ctctcttr,ctctcttl]
ctcttrct	[cttlctct,ctcttlct,cttrctct,ctcttrct]
ctcttrcl	[cttlctcl,ctcttlcr,cttrctcr,ctcttrcl]
ctrclclc	[ctlcrcrc,crcrctlc,ctrclclc,clclctrc]
ccrccttc	[cttcclcc,cclccttc,cttccrcc,ccrccttc]
ccrccttt	[cclccttt,cclccttt,ccrccttt,ccrccttt]
ccrrrcrr	[clllccrr,cclllcll,crrrccll,ccrrrcrr]
ccrrrcrc	[clclllcc,cclllclc,crcrrrcc,ccrrrcrc]
ctcrcclc	[ctclccrc,crcclctc,ctcrcclc,clccrctc]
ccrrrctl	[clllcctl,cclllctr,crrrcctr,ccrrrctl]
ccrcctcl	[ctcclccl,cclcctcr,ctccrccr,ccrcctcl]
ccrcctct	[ctcclcct,cclcctct,ctccrcct,ccrcctct]
ccrccrrr	[cclcclll,cclccrrr,ccrccrrr,ccrcclll]
cttcrrrc	[clllcttc,cttclllc,crrrcttc,cttcrrrc]
ccrcctcr	[ctcclccr,cclcctcl,ctccrccl,ccrcctcr]
cctrctcl	[ctctlccl,cctlctcr,ctctrccr,cctrctcl]
cctrctcr	[ctctlccr,cctlctcl,ctctrccl,cctrctcr]
crccrctt	[clcclctt,clcclctt,crccrctt,crccrctt]
crccrctr	[clcclctl,clcclctr,crccrctr,crccrctl]
cctrcrrc	[cllctlcc,cctlcllc,crrctrcc,cctrcrrc]
cctrctct	[ctctlcct,cctlctct,ctctrcct,cctrctct]
cctrcrrr	[ctlccrrr,cctlclll,ctrcclll,cctrcrrr]
ctrclcrr	[ctlcrcll,crctlcrr,ctrclcrr,clctrcll]
ctctcrrc	[cllctctc,ctctcllc,crrctctc,ctctcrrc]
ctctctcr	[ctctctcl,ctctctcr,ctctctcr,ctctctcl]
ctrclcrc	[ctlcrclc,clcrctlc,ctrclcrc,crclctrc]
ctctctct	[ctctctct,ctctctct,ctctctct,ctctctct]
ctctcrrr	[ctctclll,ctctcrrr,ctctcrrr,ctctclll]
ccrcctrr	[cclcctll,cclcctrr,ccrcctrr,ccrcctll]
ccrctllc	[ctllcrcc,ccrctllc,ctrrclcc,cclctrrc]
ccrcctrc	[ctlcclcc,cclcctlc,ctrccrcc,ccrcctrc]
ccrrrctr	[clllcctr,cclllctl,crrrcctl,ccrrrctr]
ccrrrctt	[clllcctt,cclllctt,crrrcctt,ccrrrctt]
ccrrrctc	[ctclllcc,cclllctc,ctcrrrcc,ccrrrctc]
ctcrccrc	[ctclcclc,clcclctc,ctcrccrc,crccrctc]
ccrrrccr	[cclllccl,cclllccr,ccrrrccr,ccrrrccl]
ctcrrrct	[clllctct,ctclllct,crrrctct,ctcrrrct]
ccrctrcl	[ctlclccl,cclctlcr,ctrcrccr,ccrctrcl]
ctcrrrcr	[clllctcr,ctclllcl,crrrctcl,ctcrrrcr]
cttctcrc	[cttctclc,clctcttc,cttctcrc,crctcttc]
ccrccttr	[cclccttl,cclccttr,ccrccttr,ccrccttl]
ccrctrcr	[ctlclccr,cclctlcl,ctrcrccl,ccrctrcr]
ctcrrrcl	[clllctcl,ctclllcr,crrrctcr,ctcrrrcl]
ccrctrct	[ctlclcct,cclctlct,ctrcrcct,ccrctrct]
cctrclll	[ctlcclll,cctlcrrr,ctrccrrr,cctrclll]
cctrcllc	[cllctrcc,cctrcllc,crrctlcc,cctlcrrc]
crrrctrr	[clllctll,clllctrr,crrrctrr,crrrctll]
ctrclctl	[ctlcrctr,crctlctl,ctrclctl,clctrctr]
ctctttct	[ctttctct,ctctttct,ctttctct,ctctttct]
ctrclctt	[ctlcrctt,crctlctt,ctrclctt,clctrctt]
ctrclctr	[ctlcrctl,crctlctr,ctrclctr,clctrctl]
ctctttcr	[ctttctcl,ctctttcr,ctttctcr,ctctttcl]
crcclllc	[clllccrc,crcclllc,crrrcclc,clccrrrc]
crcctclc	[clctccrc,crcctclc,crctcclc,clcctcrc]
ccrcttct	[cttclcct,cclcttct,cttcrcct,ccrcttct]
cttcttct	[cttcttct,cttcttct,cttcttct,cttcttct]
ccrcctlc	[ctlccrcc,ccrcctlc,ctrcclcc,cclcctrc]
ccrctrrc	[ctllclcc,cclctllc,ctrrcrcc,ccrctrrc]
cttcttcr	[cttcttcl,cttcttcr,cttcttcr,cttcttcl]
cttctttc	[ctttcttc,cttctttc,ctttcttc,cttctttc]
cctrcrcr	[clctlccr,cctlclcl,crctrccl,cctrcrcr]
cctrcrct	[clctlcct,cctlclct,crctrcct,cctrcrct]
cctrcrcl	[clctlccl,cctlclcr,crctrccr,cctrcrcl]
crrrcttr	[clllcttl,clllcttr,crrrcttr,crrrcttl]
crrrcttt	[clllcttt,clllcttt,crrrcttt,crrrcttt]
cctrcrcc	[cctlclcc,cclctlcc,cctrcrcc,ccrctrcc]
ctctctrc	[ctlctctc,ctctctlc,ctrctctc,ctctctrc]
ctrcrcll	[ctlclcrr,clctlcll,ctrcrcll,crctrcrr]
ctctctrr	[ctctctll,ctctctrr,ctctctrr,ctctctll]
crcctcrc	[clctcclc,clcctclc,crctccrc,crcctcrc]
ctrcrclc	[ctlclcrc,crclctlc,ctrcrclc,clcrctrc]
ccrcrrct	[cllclcct,cclcllct,crrcrcct,ccrcrrct]
ccrrrclc	[clcrrrcc,ccrrrclc,crclllcc,cclllcrc]
ccrcrrcc	[ccllclcc,cclcllcc,ccrrcrcc,ccrcrrcc]
cttcrrct	[cllcttct,cttcllct,crrcttct,cttcrrct]
ccrctttc	[ctttclcc,cclctttc,ctttcrcc,ccrctttc]
cttcrrcr	[cllcttcr,cttcllcl,crrcttcl,cttcrrcr]
cttcrrcl	[cllcttcl,cttcllcr,crrcttcr,cttcrrcl]
ccrrrcll	[clllccll,cclllcrr,crrrccrr,ccrrrcll]
ccrcttcl	[cttclccl,cclcttcr,cttcrccr,ccrcttcl]
cttcttrc	[cttlcttc,cttcttlc,cttrcttc,cttcttrc]
ccrcttcr	[cttclccr,cclcttcl,cttcrccl,ccrcttcr]
crccrrrc	[clllcclc,clcclllc,crrrccrc,crccrrrc]
crrrcrrr	[clllclll,clllcrrr,crrrcrrr,crrrclll]
crrccllc	[cllccrrc,crrccllc,crrccllc,cllccrrc]
cttccttc	[cttccttc,cttccttc,cttccttc,cttccttc]
cttctrct	[ctlcttct,cttctlct,ctrcttct,cttctrct]
cttctrcr	[ctlcttcr,cttctlcl,ctrcttcl,cttctrcr]
cttctrcl	[ctlcttcl,cttctlcr,ctrcttcr,cttctrcl]
ctcrrcrc	[ctcllclc,clcllctc,ctcrrcrc,crcrrctc]
ctcrrctc	[ctcllctc,ctcllctc,ctcrrctc,ctcrrctc]
ctcrrctt	[cllctctt,ctcllctt,crrctctt,ctcrrctt]
ccrcclcl	[clccrccr,ccrcclcl,crcclccl,cclccrcr]
ctcrrctr	[cllctctr,ctcllctl,crrctctl,ctcrrctr]
ctcrrctl	[cllctctl,ctcllctr,crrctctr,ctcrrctl]
ccrcclct	[clccrcct,ccrcclct,crcclcct,cclccrct]
ccrcclcr	[clccrccl,ccrcclcr,crcclccr,cclccrcl]
ccrcclcc	[cclccrcc,ccrcclcc,ccrcclcc,cclccrcc]
cctrclct	[clctrcct,cctrclct,crctlcct,cctlcrct]
cttcctrc	[ctlccttc,cttcctlc,ctrccttc,cttcctrc]
cctrclcc	[cctlcrcc,ccrctlcc,cctrclcc,cclctrcc]
crccllct	[cllccrct,crccllct,crrcclct,clccrrct]
cctrclcl	[clctrccr,cctrclcl,crctlccl,cctlcrcr]
cctrclcr	[clctrccl,cctrclcr,crctlccr,cctlcrcl]
crccllcr	[cllccrcl,crccllcr,crrcclcr,clccrrcl]
crccllcl	[cllccrcr,crccllcl,crrcclcl,clccrrcr]
ctctccrc	[ctctcclc,clcctctc,ctctccrc,crcctctc]
ctctrrct	[ctllctct,ctctllct,ctrrctct,ctctrrct]
ctctrrcr	[ctllctcr,ctctllcl,ctrrctcl,ctctrrcr]
ctctrrcl	[ctllctcl,ctctllcr,ctrrctcr,ctctrrcl]
ccrrcclc	[clccrrcc,ccrrcclc,crccllcc,ccllccrc]
ctcctrct	[ctlcctct,ctcctlct,ctrcctct,ctcctrct]
ccrrccrr	[ccllccll,ccllccrr,ccrrccrr,ccrrccll]
ctcctrcl	[ctlcctcl,ctcctlcr,ctrcctcr,ctcctrcl]
ctcctrcr	[ctlcctcr,ctcctlcl,ctrcctcl,ctcctrcr]
cttctrrc	[ctllcttc,cttctllc,ctrrcttc,cttctrrc]
crccrrct	[cllcclct,clccllct,crrccrct,crccrrct]
crccrrcr	[cllcclcr,clccllcl,crrccrcl,crccrrcr]
crccrrcl	[cllcclcl,clccllcr,crrccrcr,crccrrcl]
ctcttcrr	[cttctcll,ctcttcrr,cttctcrr,ctcttcll]
ccrccllc	[cllccrcc,ccrccllc,crrcclcc,cclccrrc]
ctttccrc	[ctttcclc,clcctttc,ctttccrc,crcctttc]
ccrrrcct	[cclllcct,cclllcct,ccrrrcct,ccrrrcct]
ctcrrcll	[cllctcll,ctcllcrr,crrctcrr,ctcrrcll]
ccrccrcr	[clcclccr,cclcclcl,crccrccl,ccrccrcr]
ccrccrcl	[clcclccl,cclcclcr,crccrccr,ccrccrcl]
ccrccrcc	[cclcclcc,cclcclcc,ccrccrcc,ccrccrcc]
ccrccrct	[clcclcct,cclcclct,crccrcct,ccrccrct]
ctcttctt	[cttctctt,ctcttctt,cttctctt,ctcttctt]
ctcttctc	[ctcttctc,ctcttctc,ctcttctc,ctcttctc]
ctcttctr	[cttctctl,ctcttctr,cttctctr,ctcttctl]
cttccrrc	[cllccttc,cttccllc,crrccttc,cttccrrc]
ccrccrrc	[cllcclcc,cclccllc,crrccrcc,ccrccrrc]
ctcrrclc	[ctcllcrc,crcllctc,ctcrrclc,clcrrctc]
ctccttcr	[cttcctcl,ctccttcr,cttcctcr,ctccttcl]
ctccttct	[cttcctct,ctccttct,cttcctct,ctccttct]
ctcrrcrr	[cllctcrr,ctcllcll,crrctcll,ctcrrcrr]
ctcctrrc	[ctllcctc,ctcctllc,ctrrcctc,ctcctrrc]
ccrctlcl	[ctlcrccr,ccrctlcl,ctrclccl,cclctrcr]
ccrctlcr	[ctlcrccl,ccrctlcr,ctrclccr,cclctrcl]
ccrctlct	[ctlcrcct,ccrctlct,ctrclcct,cclctrct]
ctcttcrc	[ctcttclc,clcttctc,ctcttcrc,crcttctc]
cctcctct	[ctcctcct,cctcctct,ctcctcct,cctcctct]
cctccrrr	[cctcclll,cctccrrr,cctccrrr,cctcclll]
cctrrctc	[ctctllcc,cctllctc,ctctrrcc,cctrrctc]
ctctrctl	[ctlctctl,ctctlctr,ctrctctr,ctctrctl]
ctrcrrrc	[clllctlc,ctlclllc,crrrctrc,ctrcrrrc]
cctcctcc	[cctcctcc,cctcctcc,cctcctcc,cctcctcc]
cctrrctt	[ctllcctt,cctllctt,ctrrcctt,cctrrctt]
ctctrctt	[ctlctctt,ctctlctt,ctrctctt,ctctrctt]
cctcctcr	[ctcctccl,cctcctcr,ctcctccr,cctcctcl]
ctctrctr	[ctlctctr,ctctlctl,ctrctctl,ctctrctr]
ccrcrctl	[clclcctl,cclclctr,crcrcctr,ccrcrctl]
crcrrclc	[clcllcrc,crcllclc,crcrrclc,clcrrcrc]
ccrcrctr	[clclcctr,cclclctl,crcrcctl,ccrcrctr]
ccrcrctt	[clclcctt,cclclctt,crcrcctt,ccrcrctt]
ccrcrctc	[ctclclcc,cclclctc,ctcrcrcc,ccrcrctc]
ctccttrc	[cttlcctc,ctccttlc,cttrcctc,ctccttrc]
ccttccrr	[ccttccll,ccttccrr,ccttccrr,ccttccll]
ctccrrcl	[cllcctcl,ctccllcr,crrcctcr,ctccrrcl]
ctcctttc	[ctttcctc,ctcctttc,ctttcctc,ctcctttc]
ctttcttt	[ctttcttt,ctttcttt,ctttcttt,ctttcttt]
crcrrcrr	[cllclcrr,clcllcll,crrcrcll,crcrrcrr]
ctttcttr	[ctttcttl,ctttcttr,ctttcttr,ctttcttl]
ctccrrct	[cllcctct,ctccllct,crrcctct,ctccrrct]
crcrrcrc	[clcllclc,clcllclc,crcrrcrc,crcrrcrc]
ctccrrcr	[cllcctcr,ctccllcl,crrcctcl,ctccrrcr]
ctctrcrc	[ctctlclc,clctlctc,ctctrcrc,crctrctc]
ctrcllcl	[ctlcrrcr,crrctlcl,ctrcllcl,cllctrcr]
cctccttc	[cttcctcc,cctccttc,cttcctcc,cctccttc]
cctrrcct	[cctllcct,cctllcct,cctrrcct,cctrrcct]
ctrcllct	[ctlcrrct,crrctlct,ctrcllct,cllctrct]
cctrrccr	[cctllccl,cctllccr,cctrrccr,cctrrccl]
ctrcllcr	[ctlcrrcl,crrctlcr,ctrcllcr,cllctrcl]
cttccrcl	[cttcclcr,clccttcl,cttccrcl,crccttcr]
cttccrcr	[cttcclcl,clccttcr,cttccrcr,crccttcl]
cttccrct	[cttcclct,clccttct,cttccrct,crccttct]
crcllcll	[cllcrcrr,crcllcll,crrclcll,clcrrcrr]
crcttcrc	[clcttclc,clcttclc,crcttcrc,crcttcrc]
ccrcrcrr	[clclccrr,cclclcll,crcrccll,ccrcrcrr]
ctccrrrc	[clllcctc,ctcclllc,crrrcctc,ctccrrrc]
ctcctctc	[ctctcctc,ctcctctc,ctctcctc,ctcctctc]
ccrcrcrc	[clclclcc,cclclclc,crcrcrcc,ccrcrcrc]
ccttcctr	[ccttcctl,ccttcctr,ccttcctr,ccttcctl]
ccttcctt	[ccttcctt,ccttcctt,ccttcctt,ccttcctt]
ccttccrc	[clccttcc,ccttcclc,crccttcc,ccttccrc]
ctttctrr	[ctttctll,ctttctrr,ctttctrr,ctttctll]
crcrrcll	[cllclcll,clcllcrr,crrcrcrr,crcrrcll]
ctttctrc	[ctlctttc,ctttctlc,ctrctttc,ctttctrc]
crcttclc	[clcttcrc,crcttclc,crcttclc,clcttcrc]
ctrcrrcr	[ctlcllcl,cllctlcr,ctrcrrcr,crrctrcl]
ctctrctc	[ctctlctc,ctctlctc,ctctrctc,ctctrctc]
ctrcrrct	[ctlcllct,cllctlct,ctrcrrct,crrctrct]
cctccrrc	[cllcctcc,cctccllc,crrcctcc,cctccrrc]
ctrcrrcl	[ctlcllcr,cllctlcl,ctrcrrcl,crrctrcr]
cctccrcc	[cctcclcc,cclcctcc,cctccrcc,ccrcctcc]
cctccrcr	[clcctccr,cctcclcl,crcctccl,cctccrcr]
ctctrcll	[ctlctcll,ctctlcrr,ctrctcrr,ctctrcll]
cctccrct	[clcctcct,cctcclct,crcctcct,cctccrct]
cttrccrc	[cttlcclc,clccttlc,cttrccrc,crccttrc]
cctccrcl	[clcctccl,cctcclcr,crcctccr,cctccrcl]
ccrclccl	[cclcrccr,ccrclccl,ccrclccl,cclcrccr]
ccrclccr	[cclcrccl,ccrclccr,ccrclccr,cclcrccl]
ccrcrcll	[clclccll,cclclcrr,crcrccrr,ccrcrcll]
ccrclcct	[cclcrcct,ccrclcct,ccrclcct,cclcrcct]
ctcctcrc	[ctcctclc,clctcctc,ctcctcrc,crctcctc]
ccttctrr	[cttcctll,ccttctrr,cttcctrr,ccttctll]
ccrcrclc	[clcrcrcc,ccrcrclc,crclclcc,cclclcrc]
ccttcctc	[ctccttcc,ccttcctc,ctccttcc,ccttcctc]
ctcctctr	[ctcctctl,ctcctctr,ctcctctr,ctcctctl]
ctcctctt	[ctcctctt,ctcctctt,ctcctctt,ctcctctt]
cttrcclc	[cttlccrc,crccttlc,cttrcclc,clccttrc]
ctrcctlc	[ctlcctrc,ctrcctlc,ctrcctlc,ctlcctrc]
ctctrcrr	[ctlctcrr,ctctlcll,ctrctcll,ctctrcrr]
ctrctrrc	[ctllctlc,ctlctllc,ctrrctrc,ctrctrrc]
crrccrrc	[cllccllc,cllccllc,crrccrrc,crrccrrc]
cttrctlc	[cttlctrc,ctrcttlc,cttrctlc,ctlcttrc]
ccrclctl	[clcrcctr,ccrclctl,crclcctl,cclcrctr]
ccrclctr	[clcrcctl,ccrclctr,crclcctr,cclcrctl]
ccrclctt	[clcrcctt,ccrclctt,crclcctt,cclcrctt]
ccttcttr	[cttccttl,ccttcttr,cttccttr,ccttcttl]
ccrclctc	[ctclcrcc,ccrclctc,ctcrclcc,cclcrctc]
ccttcttt	[cttccttt,ccttcttt,cttccttt,ccttcttt]
ccttcttc	[cttcttcc,ccttcttc,cttcttcc,ccttcttc]
ccttctrc	[ctlcttcc,ccttctlc,ctrcttcc,ccttctrc]
ctcctcrr	[ctcctcll,ctcctcrr,ctcctcrr,ctcctcll]
ctttcrrr	[ctttclll,ctttcrrr,ctttcrrr,ctttclll]
ctttcrrc	[cllctttc,ctttcllc,crrctttc,ctttcrrc]
crctrcrc	[clctlclc,clctlclc,crctrcrc,crctrcrc]
ctctrclc	[ctctlcrc,crctlctc,ctctrclc,clctrctc]
ctrcrcrr	[ctlclcll,clctlcrr,ctrcrcrr,crctrcll]
cctrcclc	[clcctrcc,cctrcclc,crcctlcc,cctlccrc]
cttrctrc	[cttlctlc,ctlcttlc,cttrctrc,ctrcttrc]
crcclcll	[clccrcrr,crcclcll,crcclcll,clccrcrr]
ctrcrcrc	[ctlclclc,clclctlc,ctrcrcrc,crcrctrc]
crcclclc	[clclccrc,crcclclc,crcrcclc,clccrcrc]
cttrctrr	[cttlctll,cttlctrr,cttrctrr,cttrctll]
ccrcllct	[cllcrcct,ccrcllct,crrclcct,cclcrrct]
ccrcllcc	[ccllcrcc,ccrcllcc,ccrrclcc,cclcrrcc]
ccrcttrc	[cttlclcc,cclcttlc,cttrcrcc,ccrcttrc]
ccttctcr	[ctcttccl,ccttctcr,ctcttccr,ccttctcl]
ctccrctt	[ctcclctt,clcctctt,ctccrctt,crcctctt]
ccttctct	[ctcttcct,ccttctct,ctcttcct,ccttctct]
ccttcrrr	[cttcclll,ccttcrrr,cttccrrr,ccttclll]
ctccrctc	[ctclcctc,ctcclctc,ctcrcctc,ctccrctc]
ccttcrrc	[cllcttcc,ccttcllc,crrcttcc,ccttcrrc]
ccrcrrcl	[cllclccl,cclcllcr,crrcrccr,ccrcrrcl]
crctrclc	[clctlcrc,crctlclc,crctrclc,clctrcrc]
ccrcrrcr	[cllclccr,cclcllcl,crrcrccl,ccrcrrcr]
crrclllc	[clllcrrc,crrclllc,crrrcllc,cllcrrrc]
cctrccrr	[cctlccll,cctlccrr,cctrccrr,cctrccll]
cttrcttr	[cttlcttl,cttlcttr,cttrcttr,cttrcttl]
ctrcrctt	[ctlclctt,clctlctt,ctrcrctt,crctrctt]
cctrccrc	[clcctlcc,cctlcclc,crcctrcc,cctrccrc]
ctrcrctl	[ctlclctr,clctlctl,ctrcrctl,crctrctr]
ctrcrctr	[ctlclctl,clctlctr,ctrcrctr,crctrctl]
crcclcrr	[clccrcll,crcclcrr,crcclcrr,clccrcll]
cttrcttt	[cttlcttt,cttlcttt,cttrcttt,cttrcttt]
crcclcrc	[clcrcclc,clccrclc,crclccrc,crcclcrc]
ccrctctl	[ctclcctl,cclctctr,ctcrcctr,ccrctctl]
ccrctctr	[ctclcctr,cclctctl,ctcrcctl,ccrctctr]
ccrctctt	[ctclcctt,cclctctt,ctcrcctt,ccrctctt]
ccrctctc	[ctctclcc,cclctctc,ctctcrcc,ccrctctc]
ccrcrrrc	[clllclcc,cclclllc,crrrcrcc,ccrcrrrc]
ccrcttlc	[cttlcrcc,ccrcttlc,cttrclcc,cclcttrc]
ctccrcrr	[ctcclcll,clcctcrr,ctccrcrr,crcctcll]
ctccrcrc	[ctcclclc,clclcctc,ctccrcrc,crcrcctc]
ctttcrcl	[ctttclcr,clctttcl,ctttcrcl,crctttcr]
ctccrctl	[ctcclctr,clcctctl,ctccrctl,crcctctr]
ctttcrct	[ctttclct,clctttct,ctttcrct,crctttct]
ctccrctr	[ctcclctl,clcctctr,ctccrctr,crcctctl]
ctttcrcr	[ctttclcl,clctttcr,ctttcrcr,crctttcl]
ccrcllcl	[cllcrccr,ccrcllcl,crrclccl,cclcrrcr]
ccrcllcr	[cllcrccl,ccrcllcr,crrclccr,cclcrrcl]
crcclctr	[clccrctl,crcclctr,crcclctr,clccrctl]
crcclctl	[clccrctr,crcclctl,crcclctl,clccrctr]
cctrcctt	[cctlcctt,cctlcctt,cctrcctt,cctrcctt]
cctrcctc	[ctcctlcc,cctlcctc,ctcctrcc,cctrcctc]
cctrcctr	[cctlcctl,cctlcctr,cctrcctr,cctrcctl]
cctrctll	[ctlcctll,cctlctrr,ctrcctrr,cctrctll]
cttrcrrr	[cttlclll,cttlcrrr,cttrcrrr,cttrclll]
cctrctlc	[ctlctrcc,cctrctlc,ctrctlcc,cctlctrc]
ctrclllc	[clllctrc,ctrclllc,crrrctlc,ctlcrrrc]
crcclctt	[clccrctt,crcclctt,crcclctt,clccrctt]
crrcllct	[cllcrrct,crrcllct,crrcllct,cllcrrct]
cttrcrrc	[cttlcllc,cllcttlc,cttrcrrc,crrcttrc]
ctrctclc	[ctlctcrc,crctctlc,ctrctclc,clctctrc]
crrcllcr	[cllcrrcl,crrcllcr,crrcllcr,cllcrrcl]
crrcllcl	[cllcrrcr,crrcllcl,crrcllcl,cllcrrcr]
ccttcrcl	[clcttccl,ccttclcr,crcttccr,ccttcrcl]
ccrctcrr	[ctclccrr,cclctcll,ctcrccll,ccrctcrr]
ccttcrcr	[clcttccr,ccttclcl,crcttccl,ccttcrcr]
ccttcrct	[clcttcct,ccttclct,crcttcct,ccttcrct]
ccrctcrc	[clctclcc,cclctclc,crctcrcc,ccrctcrc]
ctccrcll	[ctcclcrr,clcctcll,ctccrcll,crcctcrr]
ccttcrcc	[ccttclcc,cclcttcc,ccttcrcc,ccrcttcc]
ctccrclc	[ctcclcrc,crclcctc,ctccrclc,clcrcctc]
crctlcrc	[clctrclc,clctrclc,crctlcrc,crctlcrc]
cctrctrc	[ctlctlcc,cctlctlc,ctrctrcc,cctrctrc]
crrcrrrc	[clllcllc,cllclllc,crrrcrrc,crrcrrrc]
cctrctrr	[ctlcctrr,cctlctll,ctrcctll,cctrctrr]
ctrctcrc	[ctlctclc,clctctlc,ctrctcrc,crctctrc]
crrcrrcr	[cllcllcl,cllcllcr,crrcrrcr,crrcrrcl]
crrcrrct	[cllcllct,cllcllct,crrcrrct,crrcrrct]
cttrcllc	[cttlcrrc,crrcttlc,cttrcllc,cllcttrc]
crccrclc	[clcrccrc,crccrclc,crclcclc,clcclcrc]
ccrcrccr	[cclclccl,cclclccr,ccrcrccr,ccrcrccl]
ccrctcll	[ctclccll,cclctcrr,ctcrccrr,ccrctcll]
ccrcrcct	[cclclcct,cclclcct,ccrcrcct,ccrcrcct]
ccrclllc	[clllcrcc,ccrclllc,crrrclcc,cclcrrrc]
ccrctclc	[clctcrcc,ccrctclc,crctclcc,cclctcrc]
cctrcttl	[ctlccttl,cctlcttr,ctrccttr,cctrcttl]
crccrcrr	[clcclcll,clcclcrr,crccrcrr,crccrcll]
cctrcttc	[cttctlcc,cctlcttc,cttctrcc,cctrcttc]
cctrcttr	[ctlccttr,cctlcttl,ctrccttl,cctrcttr]
cctrcttt	[ctlccttt,cctlcttt,ctrccttt,cctrcttt]
crctcrcr	[clctclcl,clctclcr,crctcrcr,crctcrcl]
cttrcrct	[cttlclct,clcttlct,cttrcrct,crcttrct]
crctcrct	[clctclct,clctclct,crctcrct,crctcrct]
cctcrccl	[cctclccr,cclctccl,cctcrccl,ccrctccr]
cttrcrcr	[cttlclcl,clcttlcr,cttrcrcr,crcttrcl]
cttrcrcl	[cttlclcr,clcttlcl,cttrcrcl,crcttrcr]
crcrctrr	[clclctll,clclctrr,crcrctrr,crcrctll]
cctcrctr	[clctcctr,cctclctl,crctcctl,cctcrctr]
cctcrctl	[clctcctl,cctclctr,crctcctr,cctcrctl]
cctcrctc	[ctclctcc,cctclctc,ctcrctcc,cctcrctc]
cctcrctt	[clctcctt,cctclctt,crctcctt,cctcrctt]
crctcllc	[cllctcrc,crctcllc,crrctclc,clctcrrc]
ctrcclcr	[ctlccrcl,crcctlcr,ctrcclcr,clcctrcl]
ctrcclcl	[ctlccrcr,crcctlcl,ctrcclcl,clcctrcr]
cctcrcct	[cctclcct,cclctcct,cctcrcct,ccrctcct]
cctcrccr	[cctclccl,cclctccr,cctcrccr,ccrctccl]
ctrcclct	[ctlccrct,crcctlct,ctrcclct,clcctrct]
cttrclct	[cttlcrct,crcttlct,cttrclct,clcttrct]
cttrclcr	[cttlcrcl,crcttlcr,cttrclcr,clcttrcl]
crctcrrc	[cllctclc,clctcllc,crrctcrc,crctcrrc]
ccttrclc	[clcttrcc,ccttrclc,crcttlcc,ccttlcrc]
cttrclcl	[cttlcrcr,crcttlcl,cttrclcl,clcttrcr]
ccttrcll	[cttlccll,ccttlcrr,cttrccrr,ccttrcll]
crcrrrcr	[clllclcr,clclllcl,crrrcrcl,crcrrrcr]
crcrrrcl	[clllclcl,clclllcr,crrrcrcr,crcrrrcl]
crcrrrct	[clllclct,clclllct,crrrcrct,crcrrrct]
cctctcrr	[ctctccll,cctctcrr,ctctccrr,cctctcll]
cctctcrc	[clctctcc,cctctclc,crctctcc,cctctcrc]
cctctccr	[cctctccl,cctctccr,cctctccr,cctctccl]
ccttrcrc	[clcttlcc,ccttlclc,crcttrcc,ccttrcrc]
ccttrcrr	[cttlccrr,ccttlcll,cttrccll,ccttrcrr]
ccttrctl	[cttlcctl,ccttlctr,cttrcctr,ccttrctl]
cctctctt	[ctctcctt,cctctctt,ctctcctt,cctctctt]
cctctctr	[ctctcctl,cctctctr,ctctcctr,cctctctl]
cctctctc	[ctctctcc,cctctctc,ctctctcc,cctctctc]
cctcrrrc	[clllctcc,cctclllc,crrrctcc,cctcrrrc]
cctcrrcl	[cllctccl,cctcllcr,crrctccr,cctcrrcl]
cctcrrct	[cllctcct,cctcllct,crrctcct,cctcrrct]
ctrcctrc	[ctlcctlc,ctlcctlc,ctrcctrc,ctrcctrc]
cctcrrcr	[cllctccr,cctcllcl,crrctccl,cctcrrcr]
ctrctllc	[ctllctrc,ctrctllc,ctrrctlc,ctlctrrc]
ccrclcrr	[clcrccll,ccrclcrr,crclccrr,cclcrcll]
ccttrctc	[ctcttlcc,ccttlctc,ctcttrcc,ccttrctc]
ccttrctt	[cttlcctt,ccttlctt,cttrcctt,ccttrctt]
ccrclcrc	[clcrclcc,cclcrclc,crclcrcc,ccrclcrc]
ccttrctr	[cttlcctr,ccttlctl,cttrcctl,ccttrctr]
ccttrccr	[ccttlccl,ccttlccr,ccttrccr,ccttrccl]
ctrrctrr	[ctllctll,ctllctrr,ctrrctrr,ctrrctll]
ctrctrct	[ctlctlct,ctlctlct,ctrctrct,ctrctrct]
cctctcct	[cctctcct,cctctcct,cctctcct,cctctcct]
cctcttrc	[cttlctcc,cctcttlc,cttrctcc,cctcttrc]
ctrctrcr	[ctlctlcl,ctlctlcr,ctrctrcr,ctrctrcl]
cctcttct	[cttctcct,cctcttct,cttctcct,cctcttct]
cctcttcr	[cttctccl,cctcttcr,cttctccr,cctcttcl]
ctrrccrc	[ctllcclc,clcctllc,ctrrccrc,crcctrrc]
ccrclcll	[clcrccrr,ccrclcll,crclccll,cclcrcrr]
ccttrcct	[ccttlcct,ccttlcct,ccttrcct,ccttrcct]
ccrclclc	[clclcrcc,ccrclclc,crcrclcc,cclcrcrc]
cctctttc	[ctttctcc,cctctttc,ctttctcc,cctctttc]
cctcrrcc	[ccllctcc,cctcllcc,ccrrctcc,cctcrrcc]
cctcctrr	[cctcctll,cctcctrr,cctcctrr,cctcctll]
cctrrcll	[ctllccll,cctllcrr,ctrrccrr,cctrrcll]
cctrrclc	[clctrrcc,cctrrclc,crctllcc,cctllcrc]
ctrccrrc	[ctlccllc,cllcctlc,ctrccrrc,crrcctrc]
crcllcrc	[clcrrclc,clcrrclc,crcllcrc,crcllcrc]
ctrrcclc	[ctllccrc,crcctllc,ctrrcclc,clcctrrc]
crcllcrr	[cllcrcll,crcllcrr,crrclcrr,clcrrcll]
cctttcrc	[clctttcc,cctttclc,crctttcc,cctttcrc]
cctttcrr	[ctttccll,cctttcrr,ctttccrr,cctttcll]
cctttctr	[ctttcctl,cctttctr,ctttcctr,cctttctl]
ctrctlcl	[ctlctrcr,ctrctlcl,ctrctlcl,ctlctrcr]
cctctrrc	[ctllctcc,cctctllc,ctrrctcc,cctctrrc]
cctcttcc	[ccttctcc,cctcttcc,ccttctcc,cctcttcc]
ctrctlcr	[ctlctrcl,ctrctlcr,ctrctlcr,ctlctrcl]
ctrctlct	[ctlctrct,ctrctlct,ctrctlct,ctlctrct]
cctccttr	[cctccttl,cctccttr,cctccttr,cctccttl]
cctctrcr	[ctlctccr,cctctlcl,ctrctccl,cctctrcr]
crcllctl	[cllcrctr,crcllctl,crrclctl,clcrrctr]
cctccttt	[cctccttt,cctccttt,cctccttt,cctccttt]
cctctrcl	[ctlctccl,cctctlcr,ctrctccr,cctctrcl]
cctrrcrr	[ctllccrr,cctllcll,ctrrccll,cctrrcrr]
cctctrcc	[cctlctcc,cctctlcc,cctrctcc,cctctrcc]
cctctrct	[ctlctcct,cctctlct,ctrctcct,cctctrct]
cctrrcrc	[clctllcc,cctllclc,crctrrcc,cctrrcrc]
ctrccllc	[ctlccrrc,crrcctlc,ctrccllc,cllcctrc]
crcllctt	[cllcrctt,crcllctt,crrclctt,clcrrctt]
crcllctr	[cllcrctl,crcllctr,crrclctr,clcrrctl]
cctttctc	[ctctttcc,cctttctc,ctctttcc,cctttctc]
cctttctt	[ctttcctt,cctttctt,ctttcctt,cctttctt]
cctttcct	[cctttcct,cctttcct,cctttcct,cctttcct]
cctttccr	[cctttccl,cctttccr,cctttccr,cctttccl]
crcrrctl	[cllclctl,clcllctr,crrcrctr,crcrrctl]
crcrrctt	[cllclctt,clcllctt,crrcrctt,crcrrctt]
crcrrctr	[cllclctr,clcllctl,crrcrctl,crcrrctr]
ctrccrcl	[ctlcclcr,clcctlcl,ctrccrcl,crcctrcr]
cctrrctr	[ctllcctr,cctllctl,ctrrcctl,cctrrctr]
ctrccrct	[ctlcclct,clcctlct,ctrccrct,crcctrct]
cctcctrc	[ctlcctcc,cctcctlc,ctrcctcc,cctcctrc]
cctrrctl	[ctllcctl,cctllctr,ctrrcctr,cctrrctl]
ctrccrcr	[ctlcclcl,clcctlcr,ctrccrcr,crcctrcl]
crclcllc	[cllclcrc,crclcllc,crrcrclc,clcrcrrc]
crclclll	[clcrcrrr,crclclll,crclclll,clcrcrrr]
ccrrctrc	[ctlcllcc,ccllctlc,ctrcrrcc,ccrrctrc]
ccrrcttr	[cllccttr,ccllcttl,crrccttl,ccrrcttr]
ccrrcttl	[cllccttl,ccllcttr,crrccttr,ccrrcttl]
ccrrcttc	[cttcllcc,ccllcttc,cttcrrcc,ccrrcttc]
ccrrcttt	[cllccttt,ccllcttt,crrccttt,ccrrcttt]
ctrrcrct	[ctllclct,clctllct,ctrrcrct,crctrrct]
ctrrcrcr	[ctllclcl,clctllcr,ctrrcrcr,crctrrcl]
ctrrcrcl	[ctllclcr,clctllcl,ctrrcrcl,crctrrcr]
ctcrclcl	[ctclcrcr,crclctcl,ctcrclcl,clcrctcr]
ctcrclcr	[ctclcrcl,crclctcr,ctcrclcr,clcrctcl]
ctcrclct	[ctclcrct,crclctct,ctcrclct,clcrctct]
crclcrcr	[clcrclcl,clcrclcr,crclcrcr,crclcrcl]
crclcrct	[clcrclct,clcrclct,crclcrct,crclcrct]
ccrrctct	[ctcllcct,ccllctct,ctcrrcct,ccrrctct]
ccrrcrrr	[cllccrrr,ccllclll,crrcclll,ccrrcrrr]
ccrrctcr	[ctcllccr,ccllctcl,ctcrrccl,ccrrctcr]
ccrrcrrc	[cllcllcc,ccllcllc,crrcrrcc,ccrrcrrc]
ccrrctcl	[ctcllccl,ccllctcr,ctcrrccr,ccrrctcl]
ctrrcllc	[ctllcrrc,crrctllc,ctrrcllc,cllctrrc]
crclcttr	[clcrcttl,crclcttr,crclcttr,clcrcttl]
crclcttt	[clcrcttt,crclcttt,crclcttt,clcrcttt]
ctcrclll	[ctclcrrr,clctclll,ctcrclll,crctcrrr]
crclcttl	[clcrcttr,crclcttl,crclcttl,clcrcttr]
ccrrccrc	[clccllcc,ccllcclc,crccrrcc,ccrrccrc]
ctcrcllc	[cllcrctc,ctcrcllc,crrclctc,ctclcrrc]
ccrrcctt	[ccllcctt,ccllcctt,ccrrcctt,ccrrcctt]
ccrrcctr	[ccllcctl,ccllcctr,ccrrcctr,ccrrcctl]
ccrrctll	[cllcctll,ccllctrr,crrcctrr,ccrrctll]
ctrrcrrc	[ctllcllc,cllctllc,ctrrcrrc,crrctrrc]
ctrrcrrr	[ctllclll,ctllcrrr,ctrrcrrr,ctrrclll]
crcrclcr	[clclcrcl,crclclcr,crcrclcr,clcrcrcl]
crcrclct	[clclcrct,crclclct,crcrclct,clcrcrct]
crcrclcl	[clclcrcr,crclclcl,crcrclcl,clcrcrcr]
crclcrrr	[clcrclll,crclcrrr,crclcrrr,clcrclll]
crclcrrc	[cllcrclc,clcrcllc,crrclcrc,crclcrrc]
ctcrcrcl	[ctclclcr,clclctcl,ctcrcrcl,crcrctcr]
ctcrcrcr	[ctclclcl,clclctcr,ctcrcrcr,crcrctcl]
ctcrcrct	[ctclclct,clclctct,ctcrcrct,crcrctct]
ccrrctlc	[ctlcrrcc,ccrrctlc,ctrcllcc,ccllctrc]
ccrrcctc	[ctccllcc,ccllcctc,ctccrrcc,ccrrcctc]
ccrrctrr	[cllcctrr,ccllctll,crrcctll,ccrrctrr]
ctrrcttt	[ctllcttt,ctllcttt,ctrrcttt,ctrrcttt]
ctrrcttr	[ctllcttl,ctllcttr,ctrrcttr,ctrrcttl]
crclctll	[clcrctrr,crclctll,crclctll,clcrctrr]
cttcrctl	[cttclctr,clcttctl,cttcrctl,crcttctr]
ctcrcttl	[ctclcttr,clctcttl,ctcrcttl,crctcttr]
ctcrcttr	[ctclcttl,clctcttr,ctcrcttr,crctcttl]
ctcrcttt	[ctclcttt,clctcttt,ctcrcttt,crctcttt]
ctcrcttc	[cttclctc,ctclcttc,cttcrctc,ctcrcttc]
crcrcrct	[clclclct,clclclct,crcrcrct,crcrcrct]
cttcrcrc	[cttclclc,clclcttc,cttcrcrc,crcrcttc]
cttcrcrr	[cttclcll,clcttcrr,cttcrcrr,crcttcll]
crcrcrcr	[clclclcl,clclclcr,crcrcrcr,crcrcrcl]
crclctrr	[clcrctll,crclctrr,crclctrr,clcrctll]
ctcrctcr	[ctclctcl,ctclctcr,ctcrctcr,ctcrctcl]
ctcrctct	[ctclctct,ctclctct,ctcrctct,ctcrctct]
ctcrcrrr	[ctclclll,clctcrrr,ctcrcrrr,crctclll]
ctcrcrrc	[cllclctc,ctclcllc,crrcrctc,ctcrcrrc]
crcrcllc	[cllcrcrc,crcrcllc,crrclclc,clclcrrc]
cttcrclc	[cttclcrc,crclcttc,cttcrclc,clcrcttc]
ccrrclcl	[clcrrccr,ccrrclcl,crcllccl,ccllcrcr]
ccrrclct	[clcrrcct,ccrrclct,crcllcct,ccllcrct]
cttcrcll	[cttclcrr,clcttcll,cttcrcll,crcttcrr]
ccrrclcr	[clcrrccl,ccrrclcr,crcllccr,ccllcrcl]
crctclct	[clctcrct,crctclct,crctclct,clctcrct]
crclllcr	[clllcrcl,crclllcr,crrrclcr,clcrrrcl]
crclllct	[clllcrct,crclllct,crrrclct,clcrrrct]
ctcrctll	[ctclctrr,clctctll,ctcrctll,crctctrr]
crclllcl	[clllcrcr,crclllcl,crrrclcl,clcrrrcr]
ctcrctlc	[ctlcrctc,ctcrctlc,ctrclctc,ctclctrc]
crctclcl	[clctcrcr,crctclcl,crctclcl,clctcrcr]
crctclcr	[clctcrcl,crctclcr,crctclcr,clctcrcl]
ccrrclll	[cllcclll,ccllcrrr,crrccrrr,ccrrclll]
crcrcrrc	[cllclclc,clclcllc,crrcrcrc,crcrcrrc]
ccrrcllc	[cllcrrcc,ccrrcllc,crrcllcc,ccllcrrc]
crcrcrrr	[clclclll,clclcrrr,crcrcrrr,crcrclll]
cctcrclc	[clcrctcc,cctcrclc,crclctcc,cctclcrc]
ctrrclct	[ctllcrct,crctllct,ctrrclct,clctrrct]
ctrrclcl	[ctllcrcr,crctllcl,ctrrclcl,clctrrcr]
cctcrcll	[clctccll,cctclcrr,crctccrr,cctcrcll]
ctrrclcr	[ctllcrcl,crctllcr,ctrrclcr,clctrrcl]
ctctcrct	[ctctclct,clctctct,ctctcrct,crctctct]
ctctcrcl	[ctctclcr,clctctcl,ctctcrcl,crctctcr]
ctctcrcr	[ctctclcl,clctctcr,ctctcrcr,crctctcl]
ctcrctrr	[ctclctll,clctctrr,ctcrctrr,crctctll]
ctcrctrc	[ctlclctc,ctclctlc,ctrcrctc,ctcrctrc]
crcrcttt	[clclcttt,clclcttt,crcrcttt,crcrcttt]
ccrrcrct	[clcllcct,ccllclct,crcrrcct,ccrrcrct]
crcrcttr	[clclcttl,clclcttr,crcrcttr,crcrcttl]
ccrrcrcr	[clcllccr,ccllclcl,crcrrccl,ccrrcrcr]
cttcrctt	[cttclctt,clcttctt,cttcrctt,crcttctt]
ccrrcrcl	[clcllccl,ccllclcr,crcrrccr,ccrrcrcl]
cttcrctr	[cttclctl,clcttctr,cttcrctr,crcttctl]
cctcrcrc	[clclctcc,cctclclc,crcrctcc,cctcrcrc]
cctcrcrr	[clctccrr,cctclcll,crctccll,cctcrcrr]
