Length 9, number of unique variants is 1381.
crclcrctt	[clcrclctt,clcrclctt,crclcrctt,crclcrctt]
crclcrctr	[clcrclctl,clcrclctr,crclcrctr,crclcrctl]
crcrrrctl	[clllclctl,clclllctr,crrrcrctr,crcrrrctl]
crcrrrctr	[clllclctr,clclllctl,crrrcrctl,crcrrrctr]
crcrrrctt	[clllclctt,clclllctt,crrrcrctt,crcrrrctt]
ctrclcrcl	[ctlcrclcr,clcrctlcl,ctrclcrcl,crclctrcr]
ctcrctclc	[ctclctcrc,crctclctc,ctcrctclc,clctcrctc]
crcrccrrc	[cllcclclc,clclccllc,crrccrcrc,crcrccrrc]
ccrcrctrr	[clclcctrr,cclclctll,crcrcctll,ccrcrctrr]
ccrcrctrc	[ctlclclcc,cclclctlc,ctrcrcrcc,ccrcrctrc]
ctccrctcr	[ctclcctcr,ctcclctcl,ctcrcctcl,ctccrctcr]
ctccrctct	[ctclcctct,ctcclctct,ctcrcctct,ctccrctct]
ctccrctcl	[ctclcctcl,ctcclctcr,ctcrcctcr,ctccrctcl]
cttcctrrc	[ctllccttc,cttcctllc,ctrrccttc,cttcctrrc]
crclcrcrr	[clcrclcll,clcrclcrr,crclcrcrr,crclcrcll]
cctrcclcl	[clcctrccr,cctrcclcl,crcctlccl,cctlccrcr]
cctrcclct	[clcctrcct,cctrcclct,crcctlcct,cctlccrct]
cctrcclcr	[clcctrccl,cctrcclcr,crcctlccr,cctlccrcl]
cctrcclcc	[cctlccrcc,ccrcctlcc,cctrcclcc,cclcctrcc]
ctcrctcrc	[ctclctclc,clctclctc,ctcrctcrc,crctcrctc]
ctcrctcrr	[ctclctcll,ctclctcrr,ctcrctcrr,ctcrctcll]
crrcclllc	[clllccrrc,crrcclllc,crrrccllc,cllccrrrc]
ccrcrctll	[clclcctll,cclclctrr,crcrcctrr,ccrcrctll]
ccrcrctlc	[ctlcrcrcc,ccrcrctlc,ctrclclcc,cclclctrc]
ctccrclll	[ctcclcrrr,clcctclll,ctccrclll,crcctcrrr]
ctctccttc	[cttcctctc,ctctccttc,cttcctctc,ctctccttc]
ctrrcrrct	[ctllcllct,cllctllct,ctrrcrrct,crrctrrct]
ctctctrct	[ctlctctct,ctctctlct,ctrctctct,ctctctrct]
ccrctcllc	[cllctcrcc,ccrctcllc,crrctclcc,cclctcrrc]
ctccrcllc	[cllcrcctc,ctccrcllc,crrclcctc,ctcclcrrc]
ccrctclll	[ctclcclll,cclctcrrr,ctcrccrrr,ccrctclll]
ctrclcrrr	[ctlcrclll,crctlcrrr,ctrclcrrr,clctrclll]
ctctctrcl	[ctlctctcl,ctctctlcr,ctrctctcr,ctctctrcl]
ctctctrcr	[ctlctctcr,ctctctlcl,ctrctctcl,ctctctrcr]
ctrclcrrc	[ctlcrcllc,cllcrctlc,ctrclcrrc,crrclctrc]
ctrrcrrcr	[ctllcllcl,cllctllcr,ctrrcrrcr,crrctrrcl]
ctrrcrrcl	[ctllcllcr,cllctllcl,ctrrcrrcl,crrctrrcr]
cctccrcrc	[clclcctcc,cctcclclc,crcrcctcc,cctccrcrc]
cctccrcrr	[clcctccrr,cctcclcll,crcctccll,cctccrcrr]
crcrrrcll	[clllclcll,clclllcrr,crrrcrcrr,crcrrrcll]
ctctttctr	[ctttctctl,ctctttctr,ctttctctr,ctctttctl]
ctctttctt	[ctttctctt,ctctttctt,ctttctctt,ctctttctt]
ctctttctc	[ctctttctc,ctctttctc,ctctttctc,ctctttctc]
crcrrrclc	[clclllcrc,crclllclc,crcrrrclc,clcrrrcrc]
cctrccllc	[cllcctrcc,cctrccllc,crrcctlcc,cctlccrrc]
ccrcrctcl	[ctclclccl,cclclctcr,ctcrcrccr,ccrcrctcl]
ccrcrctcr	[ctclclccr,cclclctcl,ctcrcrccl,ccrcrctcr]
ccrcrctct	[ctclclcct,cclclctct,ctcrcrcct,ccrcrctct]
ctctcctrc	[ctlcctctc,ctctcctlc,ctrcctctc,ctctcctrc]
ctrrcllct	[ctllcrrct,crrctllct,ctrrcllct,cllctrrct]
cttcttcrc	[cttcttclc,clcttcttc,cttcttcrc,crcttcttc]
ccrrclcrr	[clcrrccll,ccrrclcrr,crcllccrr,ccllcrcll]
cttcttcrr	[cttcttcll,cttcttcrr,cttcttcrr,cttcttcll]
ccrctclcc	[cclctcrcc,ccrctclcc,ccrctclcc,cclctcrcc]
ccrrclcrc	[clcrcllcc,ccllcrclc,crclcrrcc,ccrrclcrc]
ccrctclcr	[clctcrccl,ccrctclcr,crctclccr,cclctcrcl]
ccrctclct	[clctcrcct,ccrctclct,crctclcct,cclctcrct]
ccttrctcl	[ctcttlccl,ccttlctcr,ctcttrccr,ccttrctcl]
ccttrctcr	[ctcttlccr,ccttlctcl,ctcttrccl,ccttrctcr]
ccttrctct	[ctcttlcct,ccttlctct,ctcttrcct,ccttrctct]
ctrrcllcl	[ctllcrrcr,crrctllcl,ctrrcllcl,cllctrrcr]
ctrrcllcr	[ctllcrrcl,crrctllcr,ctrrcllcr,cllctrrcl]
ctctttcrc	[ctctttclc,clctttctc,ctctttcrc,crctttctc]
cctccrcll	[clcctccll,cctcclcrr,crcctccrr,cctccrcll]
crcrrrcrr	[clllclcrr,clclllcll,crrrcrcll,crcrrrcrr]
cctccrclc	[clcrcctcc,cctccrclc,crclcctcc,cctcclcrc]
ctctttcrr	[ctttctcll,ctctttcrr,ctttctcrr,ctctttcll]
crcrrrcrc	[clclllclc,clclllclc,crcrrrcrc,crcrrrcrc]
ccrctclcl	[clctcrccr,ccrctclcl,crctclccl,cclctcrcr]
ccrcrcttl	[clclccttl,cclclcttr,crcrccttr,ccrcrcttl]
ccrcrcttr	[clclccttr,cclclcttl,crcrccttl,ccrcrcttr]
ccrcrcttt	[clclccttt,cclclcttt,crcrccttt,ccrcrcttt]
crrccrrrc	[clllccllc,cllcclllc,crrrccrrc,crrccrrrc]
ccrcrcttc	[cttclclcc,cclclcttc,cttcrcrcc,ccrcrcttc]
ccrrclctl	[clcrrcctr,ccrrclctl,crcllcctl,ccllcrctr]
ctctctrrc	[ctllctctc,ctctctllc,ctrrctctc,ctctctrrc]
ccrrclctt	[clcrrcctt,ccrrclctt,crcllcctt,ccllcrctt]
ctrrcrrrc	[ctllclllc,clllctllc,ctrrcrrrc,crrrctrrc]
ccrrclctr	[clcrrcctl,ccrrclctr,crcllcctr,ccllcrctl]
ccrrclctc	[ctclcrrcc,ccrrclctc,ctcrcllcc,ccllcrctc]
ctrclcrct	[ctlcrclct,clcrctlct,ctrclcrct,crclctrct]
ccttrclll	[cttlcclll,ccttlcrrr,cttrccrrr,ccttrclll]
ctrclcrcr	[ctlcrclcl,clcrctlcr,ctrclcrcr,crclctrcl]
ccttrcllc	[cllcttrcc,ccttrcllc,crrcttlcc,ccttlcrrc]
crclclllc	[clllclcrc,crclclllc,crrrcrclc,clcrcrrrc]
crcclcrrr	[clccrclll,crcclcrrr,crcclcrrr,clccrclll]
cctrrctrr	[ctllcctrr,cctllctll,ctrrcctll,cctrrctrr]
crcclcrrc	[cllcrcclc,clccrcllc,crrclccrc,crcclcrrc]
crrccllcl	[cllccrrcr,crrccllcl,crrccllcl,cllccrrcr]
ctrcrcrct	[ctlclclct,clclctlct,ctrcrcrct,crcrctrct]
ctrcrcrcr	[ctlclclcl,clclctlcr,ctrcrcrcr,crcrctrcl]
crrccllct	[cllccrrct,crrccllct,crrccllct,cllccrrct]
ctrcrcrcl	[ctlclclcr,clclctlcl,ctrcrcrcl,crcrctrcr]
crrccllcr	[cllccrrcl,crrccllcr,crrccllcr,cllccrrcl]
cctrrctrc	[ctlctllcc,cctllctlc,ctrctrrcc,cctrrctrc]
ccrctctrc	[ctlctclcc,cclctctlc,ctrctcrcc,ccrctctrc]
ccrrctcrc	[clctcllcc,ccllctclc,crctcrrcc,ccrrctcrc]
ccrctctrr	[ctclcctrr,cclctctll,ctcrcctll,ccrctctrr]
ccrrctcrr	[ctcllccrr,ccllctcll,ctcrrccll,ccrrctcrr]
ccrcllccl	[ccllcrccr,ccrcllccl,ccrrclccl,cclcrrccr]
ccrcllcct	[ccllcrcct,ccrcllcct,ccrrclcct,cclcrrcct]
ccttrctrc	[ctlcttlcc,ccttlctlc,ctrcttrcc,ccttrctrc]
ccrcllccr	[ccllcrccl,ccrcllccr,ccrrclccr,cclcrrccl]
ccttrctrr	[cttlcctrr,ccttlctll,cttrcctll,ccttrctrr]
cttcctcrc	[cttcctclc,clctccttc,cttcctcrc,crctccttc]
cctrrctll	[ctllcctll,cctllctrr,ctrrcctrr,cctrrctll]
ctcctctct	[ctctcctct,ctcctctct,ctctcctct,ctcctctct]
crrccrrct	[cllccllct,cllccllct,crrccrrct,crrccrrct]
ctcctctcr	[ctctcctcl,ctcctctcr,ctctcctcr,ctcctctcl]
crrccrrcr	[cllccllcl,cllccllcr,crrccrrcr,crrccrrcl]
ctcrctrrc	[ctllclctc,ctclctllc,ctrrcrctc,ctcrctrrc]
ctcrcctlc	[ctlccrctc,ctcrcctlc,ctrcclctc,ctclcctrc]
cctrrctlc	[ctlctrrcc,cctrrctlc,ctrctllcc,cctllctrc]
ccrrctctc	[ctctcllcc,ccllctctc,ctctcrrcc,ccrrctctc]
ccrctctlc	[ctlctcrcc,ccrctctlc,ctrctclcc,cclctctrc]
ccrctctll	[ctclcctll,cclctctrr,ctcrcctrr,ccrctctll]
ccrrctctr	[ctcllcctr,ccllctctl,ctcrrcctl,ccrrctctr]
ctccrctll	[ctcclctrr,clcctctll,ctccrctll,crcctctrr]
ccrrctctt	[ctcllcctt,ccllctctt,ctcrrcctt,ccrrctctt]
ctrrccrrc	[ctllccllc,cllcctllc,ctrrccrrc,crrcctrrc]
ccttrcttl	[cttlccttl,ccttlcttr,cttrccttr,ccttrcttl]
ccttrcttc	[cttcttlcc,ccttlcttc,cttcttrcc,ccttrcttc]
ccrrctctl	[ctcllcctl,ccllctctr,ctcrrcctr,ccrrctctl]
ctccrctlc	[ctlcrcctc,ctccrctlc,ctrclcctc,ctcclctrc]
ccttrcttr	[cttlccttr,ccttlcttl,cttrccttl,ccttrcttr]
ccttrcttt	[cttlccttt,ccttlcttt,cttrccttt,ccttrcttt]
ctrclccrc	[ctlcrcclc,clccrctlc,ctrclccrc,crcclctrc]
cctrrctct	[ctctllcct,cctllctct,ctctrrcct,cctrrctct]
crcclcrct	[clcrcclct,clccrclct,crclccrct,crcclcrct]
cctrrctcr	[ctctllccr,cctllctcl,ctctrrccl,cctrrctcr]
ctrcrcrrc	[ctlclcllc,cllclctlc,ctrcrcrrc,crrcrctrc]
ctrcrcrrr	[ctlclclll,clctlcrrr,ctrcrcrrr,crctrclll]
cctrrctcl	[ctctllccl,cctllctcr,ctctrrccr,cctrrctcl]
crcclcrcl	[clcrcclcl,clccrclcr,crclccrcr,crcclcrcl]
crcclcrcr	[clcrcclcr,clccrclcl,crclccrcl,crcclcrcr]
ctcrctctt	[ctclctctt,ctclctctt,ctcrctctt,ctcrctctt]
ctcrctctr	[ctclctctl,ctclctctr,ctcrctctr,ctcrctctl]
ctctctctr	[ctctctctl,ctctctctr,ctctctctr,ctctctctl]
ctctctctt	[ctctctctt,ctctctctt,ctctctctt,ctctctctt]
ctccrctrr	[ctcclctll,clcctctrr,ctccrctrr,crcctctll]
ccrctctcr	[ctctclccr,cclctctcl,ctctcrccl,ccrctctcr]
ccrctctct	[ctctclcct,cclctctct,ctctcrcct,ccrctctct]
ctctctctc	[ctctctctc,ctctctctc,ctctctctc,ctctctctc]
ccrctctcl	[ctctclccl,cclctctcr,ctctcrccr,ccrctctcl]
ctttctcrc	[ctttctclc,clctctttc,ctttctcrc,crctctttc]
ctccrctrc	[ctlclcctc,ctcclctlc,ctrcrcctc,ctccrctrc]
crclcrclc	[clcrclcrc,crclcrclc,crclcrclc,clcrclcrc]
cctrrcttr	[ctllccttr,cctllcttl,ctrrccttl,cctrrcttr]
cctrrcttl	[ctllccttl,cctllcttr,ctrrccttr,cctrrcttl]
cctrrcttc	[cttctllcc,cctllcttc,cttctrrcc,cctrrcttc]
cctrrcttt	[ctllccttt,cctllcttt,ctrrccttt,cctrrcttt]
cctttctcr	[ctctttccl,cctttctcr,ctctttccr,cctttctcl]
cctttctct	[ctctttcct,cctttctct,ctctttcct,cctttctct]
ctccrcttl	[ctcclcttr,clcctcttl,ctccrcttl,crcctcttr]
ctccrcttr	[ctcclcttl,clcctcttr,ctccrcttr,crcctcttl]
ctctctcrr	[ctctctcll,ctctctcrr,ctctctcrr,ctctctcll]
ccttrctlc	[ctlcttrcc,ccttrctlc,ctrcttlcc,ccttlctrc]
ccrctcttt	[ctclccttt,cclctcttt,ctcrccttt,ccrctcttt]
ctccrcttt	[ctcclcttt,clcctcttt,ctccrcttt,crcctcttt]
ccrctcttc	[cttctclcc,cclctcttc,cttctcrcc,ccrctcttc]
ccrrctcll	[ctcllccll,ccllctcrr,ctcrrccrr,ccrrctcll]
ctccrcttc	[cttclcctc,ctcclcttc,cttcrcctc,ctccrcttc]
ctrrctllc	[ctllctrrc,ctrrctllc,ctrrctllc,ctllctrrc]
ccrctcttl	[ctclccttl,cclctcttr,ctcrccttr,ccrctcttl]
ccrcttrcr	[cttlclccr,cclcttlcl,cttrcrccl,ccrcttrcr]
ccrctcttr	[ctclccttr,cclctcttl,ctcrccttl,ccrctcttr]
ccrcttrct	[cttlclcct,cclcttlct,cttrcrcct,ccrcttrct]
ccrrctclc	[clctcrrcc,ccrrctclc,crctcllcc,ccllctcrc]
ccrcttrcl	[cttlclccl,cclcttlcr,cttrcrccr,ccrcttrcl]
ctctctcrc	[ctctctclc,clctctctc,ctctctcrc,crctctctc]
ccttrctll	[cttlcctll,ccttlctrr,cttrcctrr,ccttrctll]
ccrcctrct	[ctlcclcct,cclcctlct,ctrccrcct,ccrcctrct]
cctcctttc	[ctttcctcc,cctcctttc,ctttcctcc,cctcctttc]
ccrcctrcl	[ctlcclccl,cclcctlcr,ctrccrccr,ccrcctrcl]
ccrcctrcr	[ctlcclccr,cclcctlcl,ctrccrccl,ccrcctrcr]
cctccrrct	[cllcctcct,cctccllct,crrcctcct,cctccrrct]
cctccrrcc	[ccllcctcc,cctccllcc,ccrrcctcc,cctccrrcc]
crcclccrc	[clccrcclc,clccrcclc,crcclccrc,crcclccrc]
cctccrrcl	[cllcctccl,cctccllcr,crrcctccr,cctccrrcl]
cctccrrcr	[cllcctccr,cctccllcl,crrcctccl,cctccrrcr]
ccrcttctt	[cttclcctt,cclcttctt,cttcrcctt,ccrcttctt]
ccrcttctc	[ctcttclcc,cclcttctc,ctcttcrcc,ccrcttctc]
ccrrcctlc	[ctlccrrcc,ccrrcctlc,ctrccllcc,ccllcctrc]
ccrcttctl	[cttclcctl,cclcttctr,cttcrcctr,ccrcttctl]
ccrcttctr	[cttclcctr,cclcttctl,cttcrcctl,ccrcttctr]
ccrrctrrc	[ctllcllcc,ccllctllc,ctrrcrrcc,ccrrctrrc]
cctctrctt	[ctlctcctt,cctctlctt,ctrctcctt,cctctrctt]
ctrctcrcl	[ctlctclcr,clctctlcl,ctrctcrcl,crctctrcr]
crccrcrrr	[clcclclll,clcclcrrr,crccrcrrr,crccrclll]
cctctrctc	[ctctlctcc,cctctlctc,ctctrctcc,cctctrctc]
ctrctcrct	[ctlctclct,clctctlct,ctrctcrct,crctctrct]
ctrctcrcr	[ctlctclcl,clctctlcr,ctrctcrcr,crctctrcl]
cttcttrcl	[cttlcttcl,cttcttlcr,cttrcttcr,cttcttrcl]
cctctrctl	[ctlctcctl,cctctlctr,ctrctcctr,cctctrctl]
crccrcrrc	[cllclcclc,clcclcllc,crrcrccrc,crccrcrrc]
cctctrctr	[ctlctcctr,cctctlctl,ctrctcctl,cctctrctr]
cttctcttc	[cttctcttc,cttctcttc,cttctcttc,cttctcttc]
cttcttrct	[cttlcttct,cttcttlct,cttrcttct,cttcttrct]
cttcttrcr	[cttlcttcr,cttcttlcl,cttrcttcl,cttcttrcr]
crcrrcrrr	[cllclcrrr,clcllclll,crrcrclll,crcrrcrrr]
cctccttrc	[cttlcctcc,cctccttlc,cttrcctcc,cctccttrc]
crcrrcrrc	[cllcllclc,clcllcllc,crrcrrcrc,crcrrcrrc]
cttrccrcl	[cttlcclcr,clccttlcl,cttrccrcl,crccttrcr]
crcclllct	[clllccrct,crcclllct,crrrcclct,clccrrrct]
cttrccrcr	[cttlcclcl,clccttlcr,cttrccrcr,crccttrcl]
crcclllcr	[clllccrcl,crcclllcr,crrrcclcr,clccrrrcl]
cttrccrct	[cttlcclct,clccttlct,cttrccrct,crccttrct]
crcclllcl	[clllccrcr,crcclllcl,crrrcclcl,clccrrrcr]
ctcrccllc	[cllccrctc,ctcrccllc,crrcclctc,ctclccrrc]
ccrcttcrr	[cttclccrr,cclcttcll,cttcrccll,ccrcttcrr]
ccrcllclc	[clcllcrcc,ccrcllclc,crcrrclcc,cclcrrcrc]
crctrrcrc	[clctllclc,clctllclc,crctrrcrc,crctrrcrc]
ccrrcctrc	[ctlccllcc,ccllcctlc,ctrccrrcc,ccrrcctrc]
cttctctrc	[ctlctcttc,cttctctlc,ctrctcttc,cttctctrc]
cctctrccl	[cctlctccl,cctctlccr,cctrctccr,cctctrccl]
cctctrccr	[cctlctccr,cctctlccl,cctrctccl,cctctrccr]
cctctrcct	[cctlctcct,cctctlcct,cctrctcct,cctctrcct]
ccrrcctrr	[ccllcctll,ccllcctrr,ccrrcctrr,ccrrcctll]
ccrcttcrc	[clcttclcc,cclcttclc,crcttcrcc,ccrcttcrc]
ccrcllcll	[cllcrccrr,ccrcllcll,crrclccll,cclcrrcrr]
ctrcrccrc	[ctlclcclc,clcclctlc,ctrcrccrc,crccrctrc]
ctrcrrrct	[clllctlct,ctlclllct,crrrctrct,ctrcrrrct]
ccrcctrrc	[ctllcclcc,cclcctllc,ctrrccrcc,ccrcctrrc]
cctcrrclc	[clcrrctcc,cctcrrclc,crcllctcc,cctcllcrc]
ctcctcttr	[ctcctcttl,ctcctcttr,ctcctcttr,ctcctcttl]
ctccttrcr	[cttlcctcr,ctccttlcl,cttrcctcl,ctccttrcr]
ctrcrrrcl	[clllctlcl,ctlclllcr,crrrctrcr,ctrcrrrcl]
ctcctcttt	[ctcctcttt,ctcctcttt,ctcctcttt,ctcctcttt]
ctccttrcl	[cttlcctcl,ctccttlcr,cttrcctcr,ctccttrcl]
cttcrctlc	[ctlcrcttc,cttcrctlc,ctrclcttc,cttclctrc]
ctrcrrrcr	[clllctlcr,ctlclllcl,crrrctrcl,ctrcrrrcr]
ctccttrct	[cttlcctct,ctccttlct,cttrcctct,ctccttrct]
cttcrctll	[cttclctrr,clcttctll,cttcrctll,crcttctrr]
cctcrrcll	[cllctccll,cctcllcrr,crrctccrr,cctcrrcll]
crctclclc	[clctcrcrc,crcrctclc,crctclclc,clclctcrc]
ctcctcttc	[cttctcctc,ctcctcttc,cttctcctc,ctcctcttc]
ctcrcctrc	[ctlcclctc,ctclcctlc,ctrccrctc,ctcrcctrc]
cctrctcrr	[ctctlccrr,cctlctcll,ctctrccll,cctrctcrr]
cctrctcrc	[clctctlcc,cctlctclc,crctctrcc,cctrctcrc]
ccrcllcrc	[clcrrclcc,cclcrrclc,crcllcrcc,ccrcllcrc]
crccrcrcl	[clclcclcl,clcclclcr,crcrccrcr,crccrcrcl]
ctrctcrrc	[ctlctcllc,cllctctlc,ctrctcrrc,crrctctrc]
crctrrclc	[clctllcrc,crctllclc,crctrrclc,clctrrcrc]
crccrcrcr	[clclcclcr,clcclclcl,crcrccrcl,crccrcrcr]
crctclcll	[clctcrcrr,crctclcll,crctclcll,clctcrcrr]
crccrcrct	[clclcclct,clcclclct,crcrccrct,crccrcrct]
ctrclllcl	[clllctrcr,ctrclllcl,crrrctlcl,ctlcrrrcr]
ctrclllcr	[clllctrcl,ctrclllcr,crrrctlcr,ctlcrrrcl]
ctrclllct	[clllctrct,ctrclllct,crrrctlct,ctlcrrrct]
ctrclcclc	[ctlcrccrc,crccrctlc,ctrclcclc,clcclctrc]
ccrcllcrr	[cllcrccll,ccrcllcrr,crrclccrr,cclcrrcll]
ctcrctrcl	[ctlclctcl,ctclctlcr,ctrcrctcr,ctcrctrcl]
ctcctctrr	[ctcctctll,ctcctctrr,ctcctctrr,ctcctctll]
cctcrrcrc	[clcllctcc,cctcllclc,crcrrctcc,cctcrrcrc]
cctrctctr	[ctctlcctr,cctlctctl,ctctrcctl,cctrctctr]
crctclcrc	[clctcrclc,clcrctclc,crctclcrc,crclctcrc]
cctcrrcrr	[cllctccrr,cctcllcll,crrctccll,cctcrrcrr]
cctrctctl	[ctctlcctl,cctlctctr,ctctrcctr,cctrctctl]
cctrctctc	[ctctctlcc,cctlctctc,ctctctrcc,cctrctctc]
cttrccrrc	[cttlccllc,cllccttlc,cttrccrrc,crrccttrc]
cctrctctt	[ctctlcctt,cctlctctt,ctctrcctt,cctrctctt]
ctcctctrc	[ctlctcctc,ctcctctlc,ctrctcctc,ctcctctrc]
cctccttct	[cttcctcct,cctccttct,cttcctcct,cctccttct]
cctccttcc	[ccttcctcc,cctccttcc,ccttcctcc,cctccttcc]
ctcrccttc	[cttcclctc,ctclccttc,cttccrctc,ctcrccttc]
ctcrctrcr	[ctlclctcr,ctclctlcl,ctrcrctcl,ctcrctrcr]
cctccttcr	[cttcctccl,cctccttcr,cttcctccr,cctccttcl]
ctcrctrct	[ctlclctct,ctclctlct,ctrcrctct,ctcrctrct]
crctclcrr	[clctcrcll,crctclcrr,crctclcrr,clctcrcll]
cttrctlct	[cttlctrct,ctrcttlct,cttrctlct,ctlcttrct]
cttrctlcr	[cttlctrcl,ctrcttlcr,cttrctlcr,ctlcttrcl]
cttrctlcl	[cttlctrcr,ctrcttlcl,cttrctlcl,ctlcttrcr]
ccrcllctr	[cllcrcctl,ccrcllctr,crrclcctr,cclcrrctl]
ctrrccrct	[ctllcclct,clcctllct,ctrrccrct,crcctrrct]
ccrcllctl	[cllcrcctr,ccrcllctl,crrclcctl,cclcrrctr]
crclccrrc	[cllccrclc,clcrccllc,crrcclcrc,crclccrrc]
ccrcllctc	[ctcllcrcc,ccrcllctc,ctcrrclcc,cclcrrctc]
ctrrccrcl	[ctllcclcr,clcctllcl,ctrrccrcl,crcctrrcr]
ccrcllctt	[cllcrcctt,ccrcllctt,crrclcctt,cclcrrctt]
ctrrccrcr	[ctllcclcl,clcctllcr,ctrrccrcr,crcctrrcl]
ctcrcclcr	[ctclccrcl,crcclctcr,ctcrcclcr,clccrctcl]
ctcrcclct	[ctclccrct,crcclctct,ctcrcclct,clccrctct]
cctccrcct	[cctcclcct,cclcctcct,cctccrcct,ccrcctcct]
ctcrcclcl	[ctclccrcr,crcclctcl,ctcrcclcl,clccrctcr]
crclcllct	[cllclcrct,crclcllct,crrcrclct,clcrcrrct]
cctrctrcl	[ctlctlccl,cctlctlcr,ctrctrccr,cctrctrcl]
crclcllcr	[cllclcrcl,crclcllcr,crrcrclcr,clcrcrrcl]
crclcllcl	[cllclcrcr,crclcllcl,crrcrclcl,clcrcrrcr]
cctrccttr	[cctlccttl,cctlccttr,cctrccttr,cctrccttl]
cctrctrct	[ctlctlcct,cctlctlct,ctrctrcct,cctrctrct]
cctrctrcr	[ctlctlccr,cctlctlcl,ctrctrccl,cctrctrcr]
cctrccttc	[cttcctlcc,cctlccttc,cttcctrcc,cctrccttc]
ctccttcrr	[cttcctcll,ctccttcrr,cttcctcrr,ctccttcll]
cctrccttt	[cctlccttt,cctlccttt,cctrccttt,cctrccttt]
cctrctrcc	[cctlctlcc,cctlctlcc,cctrctrcc,cctrctrcc]
ctccttcrc	[ctccttclc,clcttcctc,ctccttcrc,crcttcctc]
cctccrccl	[cctcclccr,cclcctccl,cctccrccl,ccrcctccr]
cctccrccr	[cctcclccl,cclcctccr,cctccrccr,ccrcctccl]
ccrrccllc	[cllccrrcc,ccrrccllc,crrccllcc,ccllccrrc]
crccrrrcl	[clllcclcl,clcclllcr,crrrccrcr,crccrrrcl]
crctclctl	[clctcrctr,crctclctl,crctclctl,clctcrctr]
crctclctr	[clctcrctl,crctclctr,crctclctr,clctcrctl]
crccrrrct	[clllcclct,clcclllct,crrrccrct,crccrrrct]
crctclctt	[clctcrctt,crctclctt,crctclctt,clctcrctt]
crccrrrcr	[clllcclcr,clcclllcl,crrrccrcl,crccrrrcr]
crccrccrc	[clcclcclc,clcclcclc,crccrccrc,crccrccrc]
cctccrctc	[ctclcctcc,cctcclctc,ctcrcctcc,cctccrctc]
crclcrrrc	[clllcrclc,clcrclllc,crrrclcrc,crclcrrrc]
crrcrcllc	[cllclcrrc,crrclcllc,crrcrcllc,cllcrcrrc]
cctccrctr	[clcctcctr,cctcclctl,crcctcctl,cctccrctr]
cctccrctt	[clcctcctt,cctcclctt,crcctcctt,cctccrctt]
cctrcctcl	[ctcctlccl,cctlcctcr,ctcctrccr,cctrcctcl]
crcctcrcl	[clctcclcl,clcctclcr,crctccrcr,crcctcrcl]
crcctcrcr	[clctcclcr,clcctclcl,crctccrcl,crcctcrcr]
cctrcctct	[ctcctlcct,cctlcctct,ctcctrcct,cctrcctct]
crcctcrct	[clctcclct,clcctclct,crctccrct,crcctcrct]
cctrcctcr	[ctcctlccr,cctlcctcl,ctcctrccl,cctrcctcr]
cctccrctl	[clcctcctl,cctcclctr,crcctcctr,cctccrctl]
ctrcrcclc	[ctlclccrc,crcclctlc,ctrcrcclc,clccrctrc]
cttcttctt	[cttcttctt,cttcttctt,cttcttctt,cttcttctt]
crccrcclc	[clcclccrc,crcclcclc,crccrcclc,clccrccrc]
cttcttctr	[cttcttctl,cttcttctr,cttcttctr,cttcttctl]
ctrcctlcr	[ctlcctrcl,ctrcctlcr,ctrcctlcr,ctlcctrcl]
ctcrrctlc	[ctlcrrctc,ctcrrctlc,ctrcllctc,ctcllctrc]
ctrcctlcl	[ctlcctrcr,ctrcctlcl,ctrcctlcl,ctlcctrcr]
ctcrrctll	[cllctctll,ctcllctrr,crrctctrr,ctcrrctll]
cctccrrrc	[clllcctcc,cctcclllc,crrrcctcc,cctccrrrc]
ccrcctcrr	[ctcclccrr,cclcctcll,ctccrccll,ccrcctcrr]
ctrcctlct	[ctlcctrct,ctrcctlct,ctrcctlct,ctlcctrct]
cctrcctlc	[ctlcctrcc,cctrcctlc,ctrcctlcc,cctlcctrc]
cctrctrrc	[ctllctlcc,cctlctllc,ctrrctrcc,cctrctrrc]
ccrcctcrc	[clctcclcc,cclcctclc,crctccrcc,ccrcctcrc]
ccrcttcll	[cttclccll,cclcttcrr,cttcrccrr,ccrcttcll]
ctrctrrcr	[ctllctlcr,ctlctllcl,ctrrctrcl,ctrctrrcr]
ctrctrrct	[ctllctlct,ctlctllct,ctrrctrct,ctrctrrct]
ccrrccttc	[cttccllcc,ccllccttc,cttccrrcc,ccrrccttc]
cctctrcll	[ctlctccll,cctctlcrr,ctrctccrr,cctctrcll]
cctctrclc	[clctrctcc,cctctrclc,crctlctcc,cctctlcrc]
ctrctrrcl	[ctllctlcl,ctlctllcr,ctrrctrcr,ctrctrrcl]
ccttrclct	[clcttrcct,ccttrclct,crcttlcct,ccttlcrct]
ccttrclcc	[ccttlcrcc,ccrcttlcc,ccttrclcc,cclcttrcc]
ccttrclcl	[clcttrccr,ccttrclcl,crcttlccl,ccttlcrcr]
ccttrclcr	[clcttrccl,ccttrclcr,crcttlccr,ccttlcrcl]
ccrrccttt	[ccllccttt,ccllccttt,ccrrccttt,ccrrccttt]
ccrrctrct	[ctlcllcct,ccllctlct,ctrcrrcct,ccrrctrct]
ccrrccttr	[ccllccttl,ccllccttr,ccrrccttr,ccrrccttl]
ctrctccrc	[ctlctcclc,clcctctlc,ctrctccrc,crcctctrc]
ccrrctrcl	[ctlcllccl,ccllctlcr,ctrcrrccr,ccrrctrcl]
ccrcttclc	[clcttcrcc,ccrcttclc,crcttclcc,cclcttcrc]
ccrrctrcr	[ctlcllccr,ccllctlcl,ctrcrrccl,ccrrctrcr]
ccrcctctl	[ctcclcctl,cclcctctr,ctccrcctr,ccrcctctl]
ccrcctctr	[ctcclcctr,cclcctctl,ctccrcctl,ccrcctctr]
ccrcctctt	[ctcclcctt,cclcctctt,ctccrcctt,ccrcctctt]
crclcrrct	[cllcrclct,clcrcllct,crrclcrct,crclcrrct]
crclcrrcr	[cllcrclcr,clcrcllcl,crrclcrcl,crclcrrcr]
crcttlcrc	[clcttrclc,clcttrclc,crcttlcrc,crcttlcrc]
crclcrrcl	[cllcrclcl,clcrcllcr,crrclcrcr,crclcrrcl]
ctccttctt	[cttcctctt,ctccttctt,cttcctctt,ctccttctt]
cctrcctrr	[cctlcctll,cctlcctrr,cctrcctrr,cctrcctll]
ctccttctr	[cttcctctl,ctccttctr,cttcctctr,ctccttctl]
crcctcrrc	[cllctcclc,clcctcllc,crrctccrc,crcctcrrc]
cctrcctrc	[ctlcctlcc,cctlcctlc,ctrcctrcc,cctrcctrc]
ctccttctc	[ctcttcctc,ctccttctc,ctcttcctc,ctccttctc]
ccrcctctc	[ctctcclcc,cclcctctc,ctctccrcc,ccrcctctc]
cttcctrcr	[ctlccttcr,cttcctlcl,ctrccttcl,cttcctrcr]
cttcctrcl	[ctlccttcl,cttcctlcr,ctrccttcr,cttcctrcl]
crcrrcrct	[clcllclct,clcllclct,crcrrcrct,crcrrcrct]
cttcctrct	[ctlccttct,cttcctlct,ctrccttct,cttcctrct]
crcrrcrcr	[clcllclcl,clcllclcr,crcrrcrcr,crcrrcrcl]
cctctrcrr	[ctlctccrr,cctctlcll,ctrctccll,cctctrcrr]
cctctrcrc	[clctlctcc,cctctlclc,crctrctcc,cctctrcrc]
ccrrcctct	[ctccllcct,ccllcctct,ctccrrcct,ccrrcctct]
ccrrcctcr	[ctccllccr,ccllcctcl,ctccrrccl,ccrrcctcr]
ccrrcctcl	[ctccllccl,ccllcctcr,ctccrrccr,ccrrcctcl]
ccrccrctl	[clcclcctl,cclcclctr,crccrcctr,ccrccrctl]
ctcrrcttt	[cllctcttt,ctcllcttt,crrctcttt,ctcrrcttt]
ccrccrctr	[clcclcctr,cclcclctl,crccrcctl,ccrccrctr]
ctcrrcttc	[cttcllctc,ctcllcttc,cttcrrctc,ctcrrcttc]
ctrcctrct	[ctlcctlct,ctlcctlct,ctrcctrct,ctrcctrct]
ctrcctrcr	[ctlcctlcl,ctlcctlcr,ctrcctrcr,ctrcctrcl]
cctrclcrr	[clctrccll,cctrclcrr,crctlccrr,cctlcrcll]
ccrccrctt	[clcclcctt,cclcclctt,crccrcctt,ccrccrctt]
ctcrrcttl	[cllctcttl,ctcllcttr,crrctcttr,ctcrrcttl]
ccrccrctc	[ctclcclcc,cclcclctc,ctcrccrcc,ccrccrctc]
ctcrrcttr	[cllctcttr,ctcllcttl,crrctcttl,ctcrrcttr]
cctrclcrc	[clcrctlcc,cctlcrclc,crclctrcc,cctrclcrc]
cttrcttlc	[cttlcttrc,cttrcttlc,cttrcttlc,cttlcttrc]
cttrcrrrc	[clllcttlc,cttlclllc,crrrcttrc,cttrcrrrc]
crctclllc	[clllctcrc,crctclllc,crrrctclc,clctcrrrc]
ccrrrccrc	[clcclllcc,cclllcclc,crccrrrcc,ccrrrccrc]
cctctcttt	[ctctccttt,cctctcttt,ctctccttt,cctctcttt]
cctcttrct	[cttlctcct,cctcttlct,cttrctcct,cctcttrct]
cctctcttr	[ctctccttl,cctctcttr,ctctccttr,cctctcttl]
cctcttrcc	[ccttlctcc,cctcttlcc,ccttrctcc,cctcttrcc]
ccrrrccrr	[cclllccll,cclllccrr,ccrrrccrr,ccrrrccll]
cctctcttc	[cttctctcc,cctctcttc,cttctctcc,cctctcttc]
cctcttrcl	[cttlctccl,cctcttlcr,cttrctccr,cctcttrcl]
cctcttrcr	[cttlctccr,cctcttlcl,cttrctccl,cctcttrcr]
ccttcttrc	[cttlcttcc,ccttcttlc,cttrcttcc,ccttcttrc]
ctcrrctrc	[ctlcllctc,ctcllctlc,ctrcrrctc,ctcrrctrc]
ccrccrccr	[cclcclccl,cclcclccr,ccrccrccr,ccrccrccl]
ctcrrctrr	[cllctctrr,ctcllctll,crrctctll,ctcrrctrr]
ccrccrcct	[cclcclcct,cclcclcct,ccrccrcct,ccrccrcct]
crcttrclc	[clcttlcrc,crcttlclc,crcttrclc,clcttrcrc]
cctrclctl	[clctrcctr,cctrclctl,crctlcctl,cctlcrctr]
ccrcclllc	[clllccrcc,ccrcclllc,crrrcclcc,cclccrrrc]
cctrclctr	[clctrcctl,cctrclctr,crctlcctr,cctlcrctl]
cctrclctt	[clctrcctt,cctrclctt,crctlcctt,cctlcrctt]
cttcrcrcl	[cttclclcr,clclcttcl,cttcrcrcl,crcrcttcr]
cctrclctc	[ctclctrcc,cctrclctc,ctcrctlcc,cctlcrctc]
cttcrcrct	[cttclclct,clclcttct,cttcrcrct,crcrcttct]
cttcrcrcr	[cttclclcl,clclcttcr,cttcrcrcr,crcrcttcl]
cttrcttrc	[cttlcttlc,cttlcttlc,cttrcttrc,cttrcttrc]
ccrrrcclc	[clccrrrcc,ccrrrcclc,crcclllcc,cclllccrc]
cttrcllcr	[cttlcrrcl,crrcttlcr,cttrcllcr,cllcttrcl]
cttrcllct	[cttlcrrct,crrcttlct,cttrcllct,cllcttrct]
cctctctcc	[cctctctcc,cctctctcc,cctctctcc,cctctctcc]
crccrrctr	[cllcclctr,clccllctl,crrccrctl,crccrrctr]
cctctctct	[ctctctcct,cctctctct,ctctctcct,cctctctct]
cttrcllcl	[cttlcrrcr,crrcttlcl,cttrcllcl,cllcttrcr]
crccrrctl	[cllcclctl,clccllctr,crrccrctr,crccrrctl]
crccrrctt	[cllcclctt,clccllctt,crrccrctt,crccrrctt]
cctctctcr	[ctctctccl,cctctctcr,ctctctccr,cctctctcl]
ccttcrrrc	[clllcttcc,ccttclllc,crrrcttcc,ccttcrrrc]
crrcrrrct	[clllcllct,cllclllct,crrrcrrct,crrcrrrct]
crrcrrrcr	[clllcllcr,cllclllcl,crrrcrrcl,crrcrrrcr]
ctcrrcllc	[cllcrrctc,ctcrrcllc,crrcllctc,ctcllcrrc]
crcttrcrc	[clcttlclc,clcttlclc,crcttrcrc,crcttrcrc]
crrcrrrcl	[clllcllcl,cllclllcr,crrrcrrcr,crrcrrrcl]
cctcrctlc	[ctlcrctcc,cctcrctlc,ctrclctcc,cctclctrc]
cctcrctll	[clctcctll,cctclctrr,crctcctrr,cctcrctll]
ctrcctrrc	[ctllcctlc,ctlcctllc,ctrrcctrc,ctrcctrrc]
ccrccrcll	[clcclccll,cclcclcrr,crccrccrr,ccrccrcll]
ctcrrclll	[cllctclll,ctcllcrrr,crrctcrrr,ctcrrclll]
crcctcclc	[clcctccrc,crcctcclc,crcctcclc,clcctccrc]
ccrccrclc	[clcrccrcc,ccrccrclc,crclcclcc,cclcclcrc]
ctrcllcrc	[ctlcrrclc,clcrrctlc,ctrcllcrc,crcllctrc]
cttrclllc	[clllcttrc,cttrclllc,crrrcttlc,cttlcrrrc]
crrctcrrc	[cllctcllc,cllctcllc,crrctcrrc,crrctcrrc]
crctcrrrc	[clllctclc,clctclllc,crrrctcrc,crctcrrrc]
ctrcttclc	[ctlcttcrc,crcttctlc,ctrcttclc,clcttctrc]
ctrcllcrr	[ctlcrrcll,crrctlcrr,ctrcllcrr,cllctrcll]
cctcrctrc	[ctlclctcc,cctclctlc,ctrcrctcc,cctcrctrc]
cctcrctrr	[clctcctrr,cctclctll,crctcctll,cctcrctrr]
crcctccrc	[clcctcclc,clcctcclc,crcctccrc,crcctccrc]
cctrclcll	[clctrccrr,cctrclcll,crctlccll,cctlcrcrr]
ccrccrcrr	[clcclccrr,cclcclcll,crccrccll,ccrccrcrr]
ctcrrctcr	[ctcllctcl,ctcllctcr,ctcrrctcr,ctcrrctcl]
ctcrrctct	[ctcllctct,ctcllctct,ctcrrctct,ctcrrctct]
ccrccrcrc	[clclcclcc,cclcclclc,crcrccrcc,ccrccrcrc]
cctrclclc	[clclctrcc,cctrclclc,crcrctlcc,cctlcrcrc]
crcllctll	[cllcrctrr,crcllctll,crrclctll,clcrrctrr]
crctcllcl	[cllctcrcr,crctcllcl,crrctclcl,clctcrrcr]
crctcllcr	[cllctcrcl,crctcllcr,crrctclcr,clctcrrcl]
ccttcrccl	[ccttclccr,cclcttccl,ccttcrccl,ccrcttccr]
ctrcllclc	[ctlcrrcrc,crcrrctlc,ctrcllclc,clcllctrc]
crctcllct	[cllctcrct,crctcllct,crrctclct,clctcrrct]
ccrrrcctc	[ctcclllcc,cclllcctc,ctccrrrcc,ccrrrcctc]
ccrrrcctt	[cclllcctt,cclllcctt,ccrrrcctt,ccrrrcctt]
ccrrrcctr	[cclllcctl,cclllcctr,ccrrrcctr,ccrrrcctl]
ccttcrcct	[ccttclcct,cclcttcct,ccttcrcct,ccrcttcct]
ctrcttcrc	[ctlcttclc,clcttctlc,ctrcttcrc,crcttctrc]
ccttcrccr	[ccttclccl,cclcttccr,ccttcrccr,ccrcttccl]
ctrcllcll	[ctlcrrcrr,crrctlcll,ctrcllcll,cllctrcrr]
crcrclctl	[clclcrctr,crclclctl,crcrclctl,clcrcrctr]
crcrclctr	[clclcrctl,crclclctr,crcrclctr,clcrcrctl]
crcrclctt	[clclcrctt,crclclctt,crcrclctt,clcrcrctt]
crctcrrcr	[cllctclcr,clctcllcl,crrctcrcl,crctcrrcr]
crctcrrcl	[cllctclcl,clctcllcr,crrctcrcr,crctcrrcl]
crctcrrct	[cllctclct,clctcllct,crrctcrct,crctcrrct]
cttrctllc	[ctllcttrc,cttrctllc,ctrrcttlc,cttlctrrc]
cctcttccr	[ccttctccl,cctcttccr,ccttctccr,cctcttccl]
ccrrrcrrc	[cllclllcc,cclllcllc,crrcrrrcc,ccrrrcrrc]
cctcttcct	[ccttctcct,cctcttcct,ccttctcct,cctcttcct]
ccrrrcrrr	[clllccrrr,cclllclll,crrrcclll,ccrrrcrrr]
ccttcrctr	[clcttcctr,ccttclctl,crcttcctl,ccttcrctr]
ccttcrctl	[clcttcctl,ccttclctr,crcttcctr,ccttcrctl]
ccttcrctc	[ctclcttcc,ccttclctc,ctcrcttcc,ccttcrctc]
ccttcrctt	[clcttcctt,ccttclctt,crcttcctt,ccttcrctt]
cctcctrcl	[ctlcctccl,cctcctlcr,ctrcctccr,cctcctrcl]
cctrctcll	[ctctlccll,cctlctcrr,ctctrccrr,cctrctcll]
crcrclcrr	[clclcrcll,crclclcrr,crcrclcrr,clcrcrcll]
cctcctrcc	[cctlcctcc,cctcctlcc,cctrcctcc,cctcctrcc]
cctrctclc	[clctctrcc,cctrctclc,crctctlcc,cctlctcrc]
cctcctrcr	[ctlcctccr,cctcctlcl,ctrcctccl,cctcctrcr]
cctcctrct	[ctlcctcct,cctcctlct,ctrcctcct,cctcctrct]
crcrclcrc	[clclcrclc,clcrclclc,crcrclcrc,crclcrcrc]
cttctcrcr	[cttctclcl,clctcttcr,cttctcrcr,crctcttcl]
ccttcrcrc	[clclcttcc,ccttclclc,crcrcttcc,ccttcrcrc]
cttctcrcl	[cttctclcr,clctcttcl,cttctcrcl,crctcttcr]
ctctrclct	[ctctlcrct,crctlctct,ctctrclct,clctrctct]
ctctrclcr	[ctctlcrcl,crctlctcr,ctctrclcr,clctrctcl]
ctctrclcl	[ctctlcrcr,crctlctcl,ctctrclcl,clctrctcr]
ccttcrcrr	[clcttccrr,ccttclcll,crcttccll,ccttcrcrr]
cttctcrct	[cttctclct,clctcttct,cttctcrct,crctcttct]
cctrclccl	[cctlcrccr,ccrctlccl,cctrclccl,cclctrccr]
ctrcctcrc	[ctlcctclc,clctcctlc,ctrcctcrc,crctcctrc]
cctrclccr	[cctlcrccl,ccrctlccr,cctrclccr,cclctrccl]
cctrclcct	[cctlcrcct,ccrctlcct,cctrclcct,cclctrcct]
crcrclcll	[clclcrcrr,crclclcll,crcrclcll,clcrcrcrr]
ctrctlctl	[ctlctrctr,ctrctlctl,ctrctlctl,ctlctrctr]
cttrcrrct	[cttlcllct,cllcttlct,cttrcrrct,crrcttrct]
crcrclclc	[clclcrcrc,crcrclclc,crcrclclc,clclcrcrc]
ctctrcllc	[cllctrctc,ctctrcllc,crrctlctc,ctctlcrrc]
cttrcrrcr	[cttlcllcl,cllcttlcr,cttrcrrcr,crrcttrcl]
ccttcrclc	[clcrcttcc,ccttcrclc,crclcttcc,ccttclcrc]
cttrcrrcl	[cttlcllcr,cllcttlcl,cttrcrrcl,crrcttrcr]
ctctrclll	[ctlctclll,ctctlcrrr,ctrctcrrr,ctctrclll]
crccrrcrr	[cllcclcrr,clccllcll,crrccrcll,crccrrcrr]
ccrrrcrct	[clclllcct,cclllclct,crcrrrcct,ccrrrcrct]
ctrctlctr	[ctlctrctl,ctrctlctr,ctrctlctr,ctlctrctl]
ccrrrcrcr	[clclllccr,cclllclcl,crcrrrccl,ccrrrcrcr]
ctrctlctt	[ctlctrctt,ctrctlctt,ctrctlctt,ctlctrctt]
crccrrcrc	[clcllcclc,clccllclc,crcrrccrc,crccrrcrc]
ccrrrcrcl	[clclllccl,cclllclcr,crcrrrccr,ccrrrcrcl]
ccttcrcll	[clcttccll,ccttclcrr,crcttccrr,ccttcrcll]
crrcrrctr	[cllcllctl,cllcllctr,crrcrrctr,crrcrrctl]
ctrcctclc	[ctlcctcrc,crctcctlc,ctrcctclc,clctcctrc]
ctcrrclcl	[ctcllcrcr,crcllctcl,ctcrrclcl,clcrrctcr]
cttcrcrrr	[cttclclll,clcttcrrr,cttcrcrrr,crcttclll]
cttcrcrrc	[cllclcttc,cttclcllc,crrcrcttc,cttcrcrrc]
crrcrrctt	[cllcllctt,cllcllctt,crrcrrctt,crrcrrctt]
ctcrrclcr	[ctcllcrcl,crcllctcr,ctcrrclcr,clcrrctcl]
ctcrrclct	[ctcllcrct,crcllctct,ctcrrclct,clcrrctct]
cctctctrr	[ctctcctll,cctctctrr,ctctcctrr,cctctctll]
cctctctrc	[ctlctctcc,cctctctlc,ctrctctcc,cctctctrc]
crccrrcll	[cllcclcll,clccllcrr,crrccrcrr,crccrrcll]
crccrrclc	[clcrrccrc,crccrrclc,crcllcclc,clccllcrc]
cctrrcrcc	[cctllclcc,cclctllcc,cctrrcrcc,ccrctrrcc]
cctrrcrct	[clctllcct,cctllclct,crctrrcct,cctrrcrct]
cctrrcrcr	[clctllccr,cctllclcl,crctrrccl,cctrrcrcr]
cctrrcrcl	[clctllccl,cctllclcr,crctrrccr,cctrrcrcl]
crrcrrcrr	[cllcllcll,cllcllcrr,crrcrrcrr,crrcrrcll]
crcctrclc	[clctrccrc,crcctrclc,crctlcclc,clcctlcrc]
cctcrclcl	[clcrctccr,cctcrclcl,crclctccl,cctclcrcr]
crctccrrc	[cllcctclc,clctccllc,crrcctcrc,crctccrrc]
ctrrcrcll	[ctllclcrr,clctllcll,ctrrcrcll,crctrrcrr]
ctctrcttc	[cttctlctc,ctctlcttc,cttctrctc,ctctrcttc]
ctrrcrclc	[ctllclcrc,crclctllc,ctrrcrclc,clcrctrrc]
ctctrcttt	[ctlctcttt,ctctlcttt,ctrctcttt,ctctrcttt]
ctrctlclc	[ctlctrcrc,crctrctlc,ctrctlclc,clctlctrc]
ccrclcllc	[cllclcrcc,ccrclcllc,crrcrclcc,cclcrcrrc]
ctctrcttr	[ctlctcttr,ctctlcttl,ctrctcttl,ctctrcttr]
ccrclclll	[clcrccrrr,ccrclclll,crclcclll,cclcrcrrr]
ctctrcttl	[ctlctcttl,ctctlcttr,ctrctcttr,ctctrcttl]
ctrctlcll	[ctlctrcrr,ctrctlcll,ctrctlcll,ctlctrcrr]
crctlcrct	[clctrclct,clctrclct,crctlcrct,crctlcrct]
crctlcrcr	[clctrclcl,clctrclcr,crctlcrcr,crctlcrcl]
cctcrclcc	[cctclcrcc,ccrclctcc,cctcrclcc,cclcrctcc]
crcctrcrc	[clctlcclc,clcctlclc,crctrccrc,crcctrcrc]
cctcrclcr	[clcrctccl,cctcrclcr,crclctccr,cctclcrcl]
cctcrclct	[clcrctcct,cctcrclct,crclctcct,cctclcrct]
ccttccrcc	[ccttcclcc,cclccttcc,ccttccrcc,ccrccttcc]
ccttccrcr	[clccttccr,ccttcclcl,crccttccl,ccttccrcr]
ccttccrct	[clccttcct,ccttcclct,crccttcct,ccttccrct]
ccttrcclc	[clccttrcc,ccttrcclc,crccttlcc,ccttlccrc]
ccttccrcl	[clccttccl,ccttcclcr,crccttccr,ccttccrcl]
ctctrctct	[ctctlctct,ctctlctct,ctctrctct,ctctrctct]
ctctrctcr	[ctctlctcl,ctctlctcr,ctctrctcr,ctctrctcl]
ctrctlcrr	[ctlctrcll,ctrctlcrr,ctrctlcrr,ctlctrcll]
ctrctlcrc	[ctlctrclc,clctrctlc,ctrctlcrc,crctlctrc]
cctttcctc	[ctcctttcc,cctttcctc,ctcctttcc,cctttcctc]
ccrclclcr	[clclcrccl,ccrclclcr,crcrclccr,cclcrcrcl]
ccrclclct	[clclcrcct,ccrclclct,crcrclcct,cclcrcrct]
ccrclclcl	[clclcrccr,ccrclclcl,crcrclccl,cclcrcrcr]
cctttcctr	[cctttcctl,cctttcctr,cctttcctr,cctttcctl]
cctttcctt	[cctttcctt,cctttcctt,cctttcctt,cctttcctt]
ctctrctlc	[ctlctrctc,ctctrctlc,ctrctlctc,ctctlctrc]
ctctrctll	[ctlctctll,ctctlctrr,ctrctctrr,ctctrctll]
ctttctrrc	[ctllctttc,ctttctllc,ctrrctttc,ctttctrrc]
cctttccrc	[clcctttcc,cctttcclc,crcctttcc,cctttccrc]
crctlcrrc	[cllctrclc,clctrcllc,crrctlcrc,crctlcrrc]
ctrcclctt	[ctlccrctt,crcctlctt,ctrcclctt,clcctrctt]
ctrcclctl	[ctlccrctr,crcctlctl,ctrcclctl,clcctrctr]
ctrcclctr	[ctlccrctl,crcctlctr,ctrcclctr,clcctrctl]
cctttccrr	[cctttccll,cctttccrr,cctttccrr,cctttccll]
ccttccrrr	[ccttcclll,ccttccrrr,ccttccrrr,ccttcclll]
ctctrctrc	[ctlctlctc,ctctlctlc,ctrctrctc,ctctrctrc]
ctctrctrr	[ctlctctrr,ctctlctll,ctrctctll,ctctrctrr]
ccttccrrc	[cllccttcc,ccttccllc,crrccttcc,ccttccrrc]
ctttcctrc	[ctlcctttc,ctttcctlc,ctrcctttc,ctttcctrc]
crcttcrrc	[cllcttclc,clcttcllc,crrcttcrc,crcttcrrc]
ctrcclcrr	[ctlccrcll,crcctlcrr,ctrcclcrr,clcctrcll]
cctcrcttt	[clctccttt,cctclcttt,crctccttt,cctcrcttt]
ctcttctct	[ctcttctct,ctcttctct,ctcttctct,ctcttctct]
cctcrcttc	[cttclctcc,cctclcttc,cttcrctcc,cctcrcttc]
ctcttctcr	[ctcttctcl,ctcttctcr,ctcttctcr,ctcttctcl]
cctcrcttl	[clctccttl,cctclcttr,crctccttr,cctcrcttl]
cctcrcttr	[clctccttr,cctclcttl,crctccttl,cctcrcttr]
ctrcclcrc	[ctlccrclc,clcrcctlc,ctrcclcrc,crclcctrc]
crcllctrr	[cllcrctll,crcllctrr,crrclctrr,clcrrctll]
ctttctrcl	[ctlctttcl,ctttctlcr,ctrctttcr,ctttctrcl]
cttrcrcrc	[cttlclclc,clclcttlc,cttrcrcrc,crcrcttrc]
ctttctrcr	[ctlctttcr,ctttctlcl,ctrctttcl,ctttctrcr]
ctttctrct	[ctlctttct,ctttctlct,ctrctttct,ctttctrct]
cttrcrcrr	[cttlclcll,clcttlcrr,cttrcrcrr,crcttrcll]
ccrclctll	[clcrcctrr,ccrclctll,crclcctll,cclcrctrr]
ccrclctlc	[ctlclcrcc,ccrclctlc,ctrcrclcc,cclcrctrc]
crcllcttl	[cllcrcttr,crcllcttl,crrclcttl,clcrrcttr]
ctcttcttc	[cttcttctc,ctcttcttc,cttcttctc,ctcttcttc]
ctcttcttt	[cttctcttt,ctcttcttt,cttctcttt,ctcttcttt]
ctcrcrcll	[ctclclcrr,clclctcll,ctcrcrcll,crcrctcrr]
ctrcclcll	[ctlccrcrr,crcctlcll,ctrcclcll,clcctrcrr]
ccrcrclll	[clclcclll,cclclcrrr,crcrccrrr,ccrcrclll]
cctcrctcc	[cctclctcc,cctclctcc,cctcrctcc,cctcrctcc]
ctcttcttr	[cttctcttl,ctcttcttr,cttctcttr,ctcttcttl]
cctcrctcr	[ctclctccr,cctclctcl,ctcrctccl,cctcrctcr]
ccrcrcllc	[cllcrcrcc,ccrcrcllc,crrclclcc,cclclcrrc]
cctcrctct	[ctclctcct,cctclctct,ctcrctcct,cctcrctct]
crcllcttr	[cllcrcttl,crcllcttr,crrclcttr,clcrrcttl]
cctcrctcl	[ctclctccl,cctclctcr,ctcrctccr,cctcrctcl]
ctrcclclc	[ctlccrcrc,crcrcctlc,ctrcclclc,clclcctrc]
crcllcttt	[cllcrcttt,crcllcttt,crrclcttt,clcrrcttt]
ccrrclcll	[clcrrccrr,ccrrclcll,crcllccll,ccllcrcrr]
cttrcrctt	[cttlclctt,clcttlctt,cttrcrctt,crcttrctt]
cttrcrctr	[cttlclctl,clcttlctr,cttrcrctr,crcttrctl]
ctrrclllc	[ctllcrrrc,crrrctllc,ctrrclllc,clllctrrc]
ctcrcrclc	[ctclclcrc,crclclctc,ctcrcrclc,clcrcrctc]
cttrcrctl	[cttlclctr,clcttlctl,cttrcrctl,crcttrctr]
ccrrclclc	[clclcrrcc,ccrrclclc,crcrcllcc,ccllcrcrc]
ccrclctrr	[clcrcctll,ccrclctrr,crclcctrr,cclcrctll]
crctrcrct	[clctlclct,clctlclct,crctrcrct,crctrcrct]
crctrcrcr	[clctlclcl,clctlclcr,crctrcrcr,crctrcrcl]
ccrclctrc	[ctlcrclcc,cclcrctlc,ctrclcrcc,ccrclctrc]
ccrclctcl	[ctclcrccr,ccrclctcl,ctcrclccl,cclcrctcr]
ctcttctrr	[cttctctll,ctcttctrr,cttctctrr,ctcttctll]
ctcttctrc	[ctlcttctc,ctcttctlc,ctrcttctc,ctcttctrc]
ccrcrclct	[clcrcrcct,ccrcrclct,crclclcct,cclclcrct]
ccrcrclcc	[cclclcrcc,ccrclclcc,ccrcrclcc,cclcrcrcc]
crcttcrcr	[clcttclcl,clcttclcr,crcttcrcr,crcttcrcl]
cctcrcllc	[cllcrctcc,cctcrcllc,crrclctcc,cctclcrrc]
crcttcrct	[clcttclct,clcttclct,crcttcrct,crcttcrct]
cctcrclll	[clctcclll,cctclcrrr,crctccrrr,cctcrclll]
ctrrcrctl	[ctllclctr,clctllctl,ctrrcrctl,crctrrctr]
ccttcttct	[cttcttcct,ccttcttct,cttcttcct,ccttcttct]
ctrrcrctt	[ctllclctt,clctllctt,ctrrcrctt,crctrrctt]
ccttcttcr	[cttcttccl,ccttcttcr,cttcttccr,ccttcttcl]
ctrrcrctr	[ctllclctl,clctllctr,ctrrcrctr,crctrrctl]
ccrclcttt	[clcrccttt,ccrclcttt,crclccttt,cclcrcttt]
ccrclcttc	[cttclcrcc,ccrclcttc,cttcrclcc,cclcrcttc]
ccrclcttl	[clcrccttr,ccrclcttl,crclccttl,cclcrcttr]
ccrclcttr	[clcrccttl,ccrclcttr,crclccttr,cclcrcttl]
ccttcttcc	[ccttcttcc,ccttcttcc,ccttcttcc,ccttcttcc]
crcllclll	[cllcrcrrr,crcllclll,crrclclll,clcrrcrrr]
crcllcllc	[cllcllcrc,crcllcllc,crrcrrclc,clcrrcrrc]
ccttcrrcl	[cllcttccl,ccttcllcr,crrcttccr,ccttcrrcl]
cttrcrclc	[cttlclcrc,crclcttlc,cttrcrclc,clcrcttrc]
ccttcrrct	[cllcttcct,ccttcllct,crrcttcct,ccttcrrct]
ctrrcrcrr	[ctllclcll,clctllcrr,ctrrcrcrr,crctrrcll]
ccttcrrcr	[cllcttccr,ccttcllcl,crrcttccl,ccttcrrcr]
cttrcrcll	[cttlclcrr,clcttlcll,cttrcrcll,crcttrcrr]
ctrrcrcrc	[ctllclclc,clclctllc,ctrrcrcrc,crcrctrrc]
ccrcrclcl	[clcrcrccr,ccrcrclcl,crclclccl,cclclcrcr]
ccrcrclcr	[clcrcrccl,ccrcrclcr,crclclccr,cclclcrcl]
crctrcrrc	[cllctlclc,clctlcllc,crrctrcrc,crctrcrrc]
ccrclctcr	[ctclcrccl,ccrclctcr,ctcrclccr,cclcrctcl]
ccrclctct	[ctclcrcct,ccrclctct,ctcrclcct,cclcrctct]
ccttctttc	[ctttcttcc,ccttctttc,ctttcttcc,ccttctttc]
ccttcrrcc	[ccllcttcc,ccttcllcc,ccrrcttcc,ccttcrrcc]
cttcctttc	[ctttccttc,cttcctttc,ctttccttc,cttcctttc]
crcclclcl	[clclccrcr,crcclclcl,crcrcclcl,clccrcrcr]
ctcttccrc	[ctcttcclc,clccttctc,ctcttccrc,crccttctc]
crcclclcr	[clclccrcl,crcclclcr,crcrcclcr,clccrcrcl]
crcclclct	[clclccrct,crcclclct,crcrcclct,clccrcrct]
crcttclcl	[clcttcrcr,crcttclcl,crcttclcl,clcttcrcr]
crcttclcr	[clcttcrcl,crcttclcr,crcttclcr,clcttcrcl]
crcttclct	[clcttcrct,crcttclct,crcttclct,clcttcrct]
ctcrclllc	[clllcrctc,ctcrclllc,crrrclctc,ctclcrrrc]
cttccrrcl	[cllccttcl,cttccllcr,crrccttcr,cttccrrcl]
cttccrrct	[cllccttct,cttccllct,crrccttct,cttccrrct]
cttccrrcr	[cllccttcr,cttccllcl,crrccttcl,cttccrrcr]
ccrrcrcll	[clcllccll,ccllclcrr,crcrrccrr,ccrrcrcll]
ctccrcrrr	[ctcclclll,clcctcrrr,ctccrcrrr,crcctclll]
ctctccrrc	[cllcctctc,ctctccllc,crrcctctc,ctctccrrc]
cttctrctt	[ctlcttctt,cttctlctt,ctrcttctt,cttctrctt]
ctccrcrrc	[cllclcctc,ctcclcllc,crrcrcctc,ctccrcrrc]
cttctrctr	[ctlcttctr,cttctlctl,ctrcttctl,cttctrctr]
ctrrctrrc	[ctllctllc,ctllctllc,ctrrctrrc,ctrrctrrc]
ccrctcrct	[clctclcct,cclctclct,crctcrcct,ccrctcrct]
ctctrrctt	[ctllctctt,ctctllctt,ctrrctctt,ctctrrctt]
ccrctcrcc	[cclctclcc,cclctclcc,ccrctcrcc,ccrctcrcc]
ctctrrctc	[ctctllctc,ctctllctc,ctctrrctc,ctctrrctc]
ccrctcrcl	[clctclccl,cclctclcr,crctcrccr,ccrctcrcl]
ctctrrctl	[ctllctctl,ctctllctr,ctrrctctr,ctctrrctl]
ccrctcrcr	[clctclccr,cclctclcl,crctcrccl,ccrctcrcr]
ccrrcrclc	[clcrcrrcc,ccrrcrclc,crclcllcc,ccllclcrc]
ctctrrctr	[ctllctctr,ctctllctl,ctrrctctl,ctctrrctr]
ccttrcrcr	[clcttlccr,ccttlclcl,crcttrccl,ccttrcrcr]
ctrclclll	[ctlcrcrrr,crctlclll,ctrclclll,clctrcrrr]
ccttrcrct	[clcttlcct,ccttlclct,crcttrcct,ccttrcrct]
ccttrcrcl	[clcttlccl,ccttlclcr,crcttrccr,ccttrcrcl]
cttctrctl	[ctlcttctl,cttctlctr,ctrcttctr,cttctrctl]
ctrclcllc	[ctlcrcrrc,crrcrctlc,ctrclcllc,cllclctrc]
ccttrcrcc	[ccttlclcc,cclcttlcc,ccttrcrcc,ccrcttrcc]
ccrcrcctr	[cclclcctl,cclclcctr,ccrcrcctr,ccrcrcctl]
ccrcrcctt	[cclclcctt,cclclcctt,ccrcrcctt,ccrcrcctt]
ccrcrcctc	[ctcclclcc,cclclcctc,ctccrcrcc,ccrcrcctc]
cttccttct	[cttccttct,cttccttct,cttccttct,cttccttct]
cttccttcr	[cttccttcl,cttccttcr,cttccttcr,cttccttcl]
ccrrcrcrr	[clcllccrr,ccllclcll,crcrrccll,ccrrcrcrr]
cttctrcrc	[cttctlclc,clctlcttc,cttctrcrc,crctrcttc]
cttctrcrr	[ctlcttcrr,cttctlcll,ctrcttcll,cttctrcrr]
ccrcttlct	[cttlcrcct,ccrcttlct,cttrclcct,cclcttrct]
ccrcttlcl	[cttlcrccr,ccrcttlcl,cttrclccl,cclcttrcr]
ccrrcrcrc	[clclcllcc,ccllclclc,crcrcrrcc,ccrrcrcrc]
ccrcttlcr	[cttlcrccl,ccrcttlcr,cttrclccr,cclcttrcl]
cctrrccrr	[cctllccll,cctllccrr,cctrrccrr,cctrrccll]
cttccrrrc	[clllccttc,cttcclllc,crrrccttc,cttccrrrc]
cctrctlcl	[ctlctrccr,cctrctlcl,ctrctlccl,cctlctrcr]
cttcrrcll	[cllcttcll,cttcllcrr,crrcttcrr,cttcrrcll]
cctrctlcr	[ctlctrccl,cctrctlcr,ctrctlccr,cctlctrcl]
cctrctlct	[ctlctrcct,cctrctlct,ctrctlcct,cctlctrct]
ctrcrclct	[ctlclcrct,crclctlct,ctrcrclct,clcrctrct]
ctrclclcr	[ctlcrcrcl,crcrctlcr,ctrclclcr,clclctrcl]
cctrctlcc	[cctlctrcc,cctrctlcc,cctrctlcc,cctlctrcc]
cttcrrclc	[cttcllcrc,crcllcttc,cttcrrclc,clcrrcttc]
ctrcrclcr	[ctlclcrcl,crclctlcr,ctrcrclcr,clcrctrcl]
ctrclclcl	[ctlcrcrcr,crcrctlcl,ctrclclcl,clclctrcr]
ctcrcrcrr	[ctclclcll,clclctcrr,ctcrcrcrr,crcrctcll]
ccrcrcrrr	[clclccrrr,cclclclll,crcrcclll,ccrcrcrrr]
ctcrcrcrc	[ctclclclc,clclclctc,ctcrcrcrc,crcrcrctc]
cctrrccrc	[clcctllcc,cctllcclc,crcctrrcc,cctrrccrc]
ccrcrcrrc	[cllclclcc,cclclcllc,crrcrcrcc,ccrcrcrrc]
ctccrcrct	[ctcclclct,clclcctct,ctccrcrct,crcrcctct]
ctctrrclc	[ctctllcrc,crctllctc,ctctrrclc,clctrrctc]
ctctrrcll	[ctllctcll,ctctllcrr,ctrrctcrr,ctctrrcll]
ctccrcrcl	[ctcclclcr,clclcctcl,ctccrcrcl,crcrcctcr]
ctccrcrcr	[ctcclclcl,clclcctcr,ctccrcrcr,crcrcctcl]
ccrclllcr	[clllcrccl,ccrclllcr,crrrclccr,cclcrrrcl]
ccrclccll	[cclcrccrr,ccrclccll,ccrclccll,cclcrccrr]
ccrclllcl	[clllcrccr,ccrclllcl,crrrclccl,cclcrrrcr]
ccrclllcc	[cclllcrcc,ccrclllcc,ccrrrclcc,cclcrrrcc]
ctttcrclc	[ctttclcrc,crclctttc,ctttcrclc,clcrctttc]
ccrclllct	[clllcrcct,ccrclllct,crrrclcct,cclcrrrct]
ccttrcrrc	[cllcttlcc,ccttlcllc,crrcttrcc,ccttrcrrc]
ccrclcclc	[clcclcrcc,ccrclcclc,crccrclcc,cclcrccrc]
ccttrcrrr	[cttlccrrr,ccttlclll,cttrcclll,ccttrcrrr]
ctttcrcll	[ctttclcrr,clctttcll,ctttcrcll,crctttcrr]
cttccttrc	[cttlccttc,cttccttlc,cttrccttc,cttccttrc]
cctrccrcr	[clcctlccr,cctlcclcl,crcctrccl,cctrccrcr]
cctrccrcl	[clcctlccl,cctlcclcr,crcctrccr,cctrccrcl]
cctrccrcc	[cctlcclcc,cclcctlcc,cctrccrcc,ccrcctrcc]
cctrccrct	[clcctlcct,cctlcclct,crcctrcct,cctrccrct]
ctcrcrctt	[ctclclctt,clclctctt,ctcrcrctt,crcrctctt]
ctcrcrctr	[ctclclctl,clclctctr,ctcrcrctr,crcrctctl]
ctcrcrctc	[ctclclctc,ctclclctc,ctcrcrctc,ctcrcrctc]
ctcrcrctl	[ctclclctr,clclctctl,ctcrcrctl,crcrctctr]
cctrrcclc	[clcctrrcc,cctrrcclc,crcctllcc,cctllccrc]
ctctcttcr	[cttctctcl,ctctcttcr,cttctctcr,ctctcttcl]
ctctrrcrc	[ctctllclc,clctllctc,ctctrrcrc,crctrrctc]
ctctcttct	[cttctctct,ctctcttct,cttctctct,ctctcttct]
ctctrrcrr	[ctllctcrr,ctctllcll,ctrrctcll,ctctrrcrr]
ccrclccrr	[cclcrccll,ccrclccrr,ccrclccrr,cclcrccll]
ctttcrcrc	[ctttclclc,clclctttc,ctttcrcrc,crcrctttc]
ccrclccrc	[clccrclcc,cclcrcclc,crcclcrcc,ccrclccrc]
ctttcrcrr	[ctttclcll,clctttcrr,ctttcrcrr,crctttcll]
ctcrctttc	[ctttclctc,ctclctttc,ctttcrctc,ctcrctttc]
ctcrcrrcr	[cllclctcr,ctclcllcl,crrcrctcl,ctcrcrrcr]
ctcrcrrcl	[cllclctcl,ctclcllcr,crrcrctcr,ctcrcrrcl]
ctcrcrrct	[cllclctct,ctclcllct,crrcrctct,ctcrcrrct]
crccrclcl	[clcrccrcr,crccrclcl,crclcclcl,clcclcrcr]
ctctctttc	[ctttctctc,ctctctttc,ctttctctc,ctctctttc]
crccrclcr	[clcrccrcl,crccrclcr,crclcclcr,clcclcrcl]
ctctcrrcr	[cllctctcr,ctctcllcl,crrctctcl,ctctcrrcr]
ctctcrrct	[cllctctct,ctctcllct,crrctctct,ctctcrrct]
ctrrccllc	[ctllccrrc,crrcctllc,ctrrccllc,cllcctrrc]
ctccrrrct	[clllcctct,ctcclllct,crrrcctct,ctccrrrct]
ctccrrrcr	[clllcctcr,ctcclllcl,crrrcctcl,ctccrrrcr]
crccrclct	[clcrccrct,crccrclct,crclcclct,clcclcrct]
ctccrrrcl	[clllcctcl,ctcclllcr,crrrcctcr,ctccrrrcl]
ctrclctll	[ctlcrctrr,crctlctll,ctrclctll,clctrctrr]
ctccrccrc	[ctcclcclc,clcclcctc,ctccrccrc,crccrcctc]
ctctcrrcl	[cllctctcl,ctctcllcr,crrctctcr,ctctcrrcl]
ctttcrctl	[ctttclctr,clctttctl,ctttcrctl,crctttctr]
crclclcrc	[clcrcrclc,clcrcrclc,crclclcrc,crclclcrc]
ctttcrctr	[ctttclctl,clctttctr,ctttcrctr,crctttctl]
ctttcrctt	[ctttclctt,clctttctt,ctttcrctt,crctttctt]
ctcttrctc	[ctcttlctc,ctcttlctc,ctcttrctc,ctcttrctc]
crcclcttl	[clccrcttr,crcclcttl,crcclcttl,clccrcttr]
crcclcttr	[clccrcttl,crcclcttr,crcclcttr,clccrcttl]
cctrrcctt	[cctllcctt,cctllcctt,cctrrcctt,cctrrcctt]
crcclcttt	[clccrcttt,crcclcttt,crcclcttt,clccrcttt]
cctrrcctr	[cctllcctl,cctllcctr,cctrrcctr,cctrrcctl]
ctcctcrrr	[ctcctclll,ctcctcrrr,ctcctcrrr,ctcctclll]
ctcttrctl	[cttlctctl,ctcttlctr,cttrctctr,ctcttrctl]
ctcttrctr	[cttlctctr,ctcttlctl,cttrctctl,ctcttrctr]
ctcttrctt	[cttlctctt,ctcttlctt,cttrctctt,ctcttrctt]
cctttcrcl	[clctttccl,cctttclcr,crctttccr,cctttcrcl]
ctcctcrrc	[cllctcctc,ctcctcllc,crrctcctc,ctcctcrrc]
cctttcrcr	[clctttccr,cctttclcl,crctttccl,cctttcrcr]
cctttcrct	[clctttcct,cctttclct,crctttcct,cctttcrct]
ctcrcttct	[cttclctct,ctclcttct,cttcrctct,ctcrcttct]
cctttcrcc	[cctttclcc,cclctttcc,cctttcrcc,ccrctttcc]
cctrrcctc	[ctcctllcc,cctllcctc,ctcctrrcc,cctrrcctc]
ctcrcttcl	[cttclctcl,ctclcttcr,cttcrctcr,ctcrcttcl]
ctcrcttcr	[cttclctcr,ctclcttcl,cttcrctcl,ctcrcttcr]
ccrctcctc	[ctcctclcc,cclctcctc,ctcctcrcc,ccrctcctc]
ccrrcrrrc	[clllcllcc,ccllclllc,crrrcrrcc,ccrrcrrrc]
ccrrcttlc	[cttlcrrcc,ccrrcttlc,cttrcllcc,ccllcttrc]
ccrctttct	[ctttclcct,cclctttct,ctttcrcct,ccrctttct]
ccrctttcl	[ctttclccl,cclctttcr,ctttcrccr,ccrctttcl]
ccrctttcr	[ctttclccr,cclctttcl,ctttcrccl,ccrctttcr]
ctctcttrc	[cttlctctc,ctctcttlc,cttrctctc,ctctcttrc]
ctrcrclcl	[ctlclcrcr,crclctlcl,ctrcrclcl,clcrctrcr]
ctccrcctc	[ctcclcctc,ctcclcctc,ctccrcctc,ctccrcctc]
cctrrcrrr	[ctllccrrr,cctllclll,ctrrcclll,cctrrcrrr]
ctcttrcrc	[ctcttlclc,clcttlctc,ctcttrcrc,crcttrctc]
cctrrcrrc	[cllctllcc,cctllcllc,crrctrrcc,cctrrcrrc]
ctcrrrcll	[clllctcll,ctclllcrr,crrrctcrr,ctcrrrcll]
ccrcrrrcc	[cclllclcc,cclclllcc,ccrrrcrcc,ccrcrrrcc]
cttccrcrr	[cttcclcll,clccttcrr,cttccrcrr,crccttcll]
ccrcrrrct	[clllclcct,cclclllct,crrrcrcct,ccrcrrrct]
ccrcctlcl	[ctlccrccr,ccrcctlcl,ctrcclccl,cclcctrcr]
ccrcrrrcr	[clllclccr,cclclllcl,crrrcrccl,ccrcrrrcr]
cttccrcrc	[cttcclclc,clclccttc,cttccrcrc,crcrccttc]
ccrcctlcr	[ctlccrccl,ccrcctlcr,ctrcclccr,cclcctrcl]
ccrcrrrcl	[clllclccl,cclclllcr,crrrcrccr,ccrcrrrcl]
ccrcctlct	[ctlccrcct,ccrcctlct,ctrcclcct,cclcctrct]
ctcttrcrr	[cttlctcrr,ctcttlcll,cttrctcll,ctcttrcrr]
ctcrrrclc	[ctclllcrc,crclllctc,ctcrrrclc,clcrrrctc]
ctcrcttlc	[cttlcrctc,ctcrcttlc,cttrclctc,ctclcttrc]
ctcrcrrrc	[clllclctc,ctclclllc,crrrcrctc,ctcrcrrrc]
ccrcrccrr	[cclclccll,cclclccrr,ccrcrccrr,ccrcrccll]
ccrcrccrc	[clcclclcc,cclclcclc,crccrcrcc,ccrcrccrc]
ccrrcrctt	[clcllcctt,ccllclctt,crcrrcctt,ccrrcrctt]
ccrrcrctc	[ctclcllcc,ccllclctc,ctcrcrrcc,ccrrcrctc]
ccttrccrc	[clccttlcc,ccttlcclc,crccttrcc,ccttrccrc]
ccrrcrctl	[clcllcctl,ccllclctr,crcrrcctr,ccrrcrctl]
cttctrcll	[ctlcttcll,cttctlcrr,ctrcttcrr,cttctrcll]
ccrctcrrc	[cllctclcc,cclctcllc,crrctcrcc,ccrctcrrc]
ccrrcrctr	[clcllcctr,ccllclctl,crcrrcctl,ccrrcrctr]
ctrctclcr	[ctlctcrcl,crctctlcr,ctrctclcr,clctctrcl]
ccrctcrrr	[ctclccrrr,cclctclll,ctcrcclll,ccrctcrrr]
ctrctclcl	[ctlctcrcr,crctctlcl,ctrctclcl,clctctrcr]
ctctcrrrc	[clllctctc,ctctclllc,crrrctctc,ctctcrrrc]
cttctrclc	[cttctlcrc,crctlcttc,cttctrclc,clctrcttc]
ctrctclct	[ctlctcrct,crctctlct,ctrctclct,clctctrct]
ctrclcttl	[ctlcrcttr,crctlcttl,ctrclcttl,clctrcttr]
ctrclcttt	[ctlcrcttt,crctlcttt,ctrclcttt,clctrcttt]
ctrclcttr	[ctlcrcttl,crctlcttr,ctrclcttr,clctrcttl]
ccttrccrr	[ccttlccll,ccttlccrr,ccttrccrr,ccttrccll]
cttccrctr	[cttcclctl,clccttctr,cttccrctr,crccttctl]
crcclclll	[clccrcrrr,crcclclll,crcclclll,clccrcrrr]
ctcctcrcl	[ctcctclcr,clctcctcl,ctcctcrcl,crctcctcr]
cttccrctl	[cttcclctr,clccttctl,cttccrctl,crccttctr]
ctcttrclc	[ctcttlcrc,crcttlctc,ctcttrclc,clcttrctc]
ctrcrcllc	[ctlclcrrc,crrclctlc,ctrcrcllc,cllcrctrc]
cttccrctt	[cttcclctt,clccttctt,cttccrctt,crccttctt]
crcclcllc	[cllclccrc,crcclcllc,crrcrcclc,clccrcrrc]
ctrcrclll	[ctlclcrrr,clctlclll,ctrcrclll,crctrcrrr]
ctcctcrcr	[ctcctclcl,clctcctcr,ctcctcrcr,crctcctcl]
ctcctcrct	[ctcctclct,clctcctct,ctcctcrct,crctcctct]
ctcttrcll	[cttlctcll,ctcttlcrr,cttrctcrr,ctcttrcll]
crcrccllc	[cllccrcrc,crcrccllc,crrcclclc,clclccrrc]
ctcrcttrc	[cttlclctc,ctclcttlc,cttrcrctc,ctcrcttrc]
ctcrcllcr	[cllcrctcl,ctcrcllcr,crrclctcr,ctclcrrcl]
cctttcrrr	[ctttcclll,cctttcrrr,ctttccrrr,cctttclll]
ctcrcllcl	[cllcrctcr,ctcrcllcl,crrclctcl,ctclcrrcr]
cctttcrrc	[cllctttcc,cctttcllc,crrctttcc,cctttcrrc]
ccrcrcclc	[clccrcrcc,ccrcrcclc,crcclclcc,cclclccrc]
ctcrcllct	[cllcrctct,ctcrcllct,crrclctct,ctclcrrct]
ccrrclllc	[clllcrrcc,ccrrclllc,crrrcllcc,ccllcrrrc]
ctrclctrr	[ctlcrctll,crctlctrr,ctrclctrr,clctrctll]
ccttrcctt	[ccttlcctt,ccttlcctt,ccttrcctt,ccttrcctt]
ctrclctrc	[ctlcrctlc,ctlcrctlc,ctrclctrc,ctrclctrc]
ccttrcctc	[ctccttlcc,ccttlcctc,ctccttrcc,ccttrcctc]
ccttrcctr	[ccttlcctl,ccttlcctr,ccttrcctr,ccttrcctl]
ctttcrrrc	[clllctttc,ctttclllc,crrrctttc,ctttcrrrc]
ctcrrrctl	[clllctctl,ctclllctr,crrrctctr,ctcrrrctl]
crcrrcttt	[cllclcttt,clcllcttt,crrcrcttt,crcrrcttt]
ccrcrrcrr	[cllclccrr,cclcllcll,crrcrccll,ccrcrrcrr]
ctrcrctrc	[ctlclctlc,ctlclctlc,ctrcrctrc,ctrcrctrc]
crcrrcttr	[cllclcttr,clcllcttl,crrcrcttl,crcrrcttr]
ctcrrrctt	[clllctctt,ctclllctt,crrrctctt,ctcrrrctt]
ctcrrrctr	[clllctctr,ctclllctl,crrrctctl,ctcrrrctr]
ctrcrctrr	[ctlclctll,clctlctrr,ctrcrctrr,crctrctll]
crctllcrc	[clctrrclc,clctrrclc,crctllcrc,crctllcrc]
cttcrcclc	[cttclccrc,crcclcttc,cttcrcclc,clccrcttc]
ctcrrrctc	[ctclllctc,ctclllctc,ctcrrrctc,ctcrrrctc]
cctrcllcl	[cllctrccr,cctrcllcl,crrctlccl,cctlcrrcr]
ctcctttct	[ctttcctct,ctcctttct,ctttcctct,ctcctttct]
cctrcllcr	[cllctrccl,cctrcllcr,crrctlccr,cctlcrrcl]
ctcctttcr	[ctttcctcl,ctcctttcr,ctttcctcr,ctcctttcl]
cctrcllct	[cllctrcct,cctrcllct,crrctlcct,cctlcrrct]
cctrcllcc	[cctlcrrcc,ccrrctlcc,cctrcllcc,ccllctrcc]
crclllcll	[clllcrcrr,crclllcll,crrrclcll,clcrrrcrr]
cctrcttrc	[cttlctlcc,cctlcttlc,cttrctrcc,cctrcttrc]
ctcctcctc	[ctcctcctc,ctcctcctc,ctcctcctc,ctcctcctc]
ctcrccrrc	[cllcclctc,ctclccllc,crrccrctc,ctcrccrrc]
crcrrcttl	[cllclcttl,clcllcttr,crrcrcttr,crcrrcttl]
ccrcrrcrc	[clcllclcc,cclcllclc,crcrrcrcc,ccrcrrcrc]
ccrrcttcr	[cttcllccr,ccllcttcl,cttcrrccl,ccrrcttcr]
ccrrcttct	[cttcllcct,ccllcttct,cttcrrcct,ccrrcttct]
ccrrcttcl	[cttcllccl,ccllcttcr,cttcrrccr,ccrrcttcl]
ctcrctlcl	[ctlcrctcr,ctcrctlcl,ctrclctcl,ctclctrcr]
ccrcrrcll	[cllclccll,cclcllcrr,crrcrccrr,ccrcrrcll]
ctcrctlcr	[ctlcrctcl,ctcrctlcr,ctrclctcr,ctclctrcl]
ctcrrrcrr	[clllctcrr,ctclllcll,crrrctcll,ctcrrrcrr]
ctrcrcttt	[ctlclcttt,clctlcttt,ctrcrcttt,crctrcttt]
ctcctrrcl	[ctllcctcl,ctcctllcr,ctrrcctcr,ctcctrrcl]
ctcrrrcrc	[ctclllclc,clclllctc,ctcrrrcrc,crcrrrctc]
ctrcrcttr	[ctlclcttl,clctlcttr,ctrcrcttr,crctrcttl]
ctrcrcttl	[ctlclcttr,clctlcttl,ctrcrcttl,crctrcttr]
cctrcrrcl	[cllctlccl,cctlcllcr,crrctrccr,cctrcrrcl]
ctcctrrct	[ctllcctct,ctcctllct,ctrrcctct,ctcctrrct]
cctrcrrcr	[cllctlccr,cctlcllcl,crrctrccl,cctrcrrcr]
ctcctrrcr	[ctllcctcr,ctcctllcl,ctrrcctcl,ctcctrrcr]
cctrcrrct	[cllctlcct,cctlcllct,crrctrcct,cctrcrrct]
ctcctccrc	[ctcctcclc,clcctcctc,ctcctccrc,crcctcctc]
cctrcrrcc	[cctlcllcc,ccllctlcc,cctrcrrcc,ccrrctrcc]
crclllcrr	[clllcrcll,crclllcrr,crrrclcrr,clcrrrcll]
cctrctttc	[ctttctlcc,cctlctttc,ctttctrcc,cctrctttc]
crclllcrc	[clcrrrclc,clcrrrclc,crclllcrc,crclllcrc]
cctcctccr	[cctcctccl,cctcctccr,cctcctccr,cctcctccl]
cctcctcct	[cctcctcct,cctcctcct,cctcctcct,cctcctcct]
ccrcrrclc	[clcrrcrcc,ccrcrrclc,crcllclcc,cclcllcrc]
ctcrctlct	[ctlcrctct,ctcrctlct,ctrclctct,ctclctrct]
ctctcrctl	[ctctclctr,clctctctl,ctctcrctl,crctctctr]
ctctcrctr	[ctctclctl,clctctctr,ctctcrctr,crctctctl]
ccrrctllc	[ctllcrrcc,ccrrctllc,ctrrcllcc,ccllctrrc]
crccrcttr	[clcclcttl,clcclcttr,crccrcttr,crccrcttl]
crccrcttt	[clcclcttt,clcclcttt,crccrcttt,crccrcttt]
ctctcrctt	[ctctclctt,clctctctt,ctctcrctt,crctctctt]
ctctcrctc	[ctclctctc,ctctclctc,ctcrctctc,ctctcrctc]
ctrrcclcl	[ctllccrcr,crcctllcl,ctrrcclcl,clcctrrcr]
ctrrcclcr	[ctllccrcl,crcctllcr,ctrrcclcr,clcctrrcl]
ctrrcclct	[ctllccrct,crcctllct,ctrrcclct,clcctrrct]
ccrccttcr	[cttcclccr,cclccttcl,cttccrccl,ccrccttcr]
crcrrctll	[cllclctll,clcllctrr,crrcrctrr,crcrrctll]
ccrccttct	[cttcclcct,cclccttct,cttccrcct,ccrccttct]
ccrcrrcct	[ccllclcct,cclcllcct,ccrrcrcct,ccrcrrcct]
crcclctrr	[clccrctll,crcclctrr,crcclctrr,clccrctll]
ccrcrrccr	[ccllclccr,cclcllccl,ccrrcrccl,ccrcrrccr]
ccrcrrccl	[ccllclccl,cclcllccr,ccrrcrccr,ccrcrrccl]
ccrccttcl	[cttcclccl,cclccttcr,cttccrccr,ccrccttcl]
crclllctr	[clllcrctl,crclllctr,crrrclctr,clcrrrctl]
crclllctt	[clllcrctt,crclllctt,crrrclctt,clcrrrctt]
ctcrctllc	[ctllcrctc,ctcrctllc,ctrrclctc,ctclctrrc]
cttrccllc	[cttlccrrc,crrccttlc,cttrccllc,cllccttrc]
crclllctl	[clllcrctr,crclllctl,crrrclctl,clcrrrctr]
ccrrcttrc	[cttlcllcc,ccllcttlc,cttrcrrcc,ccrrcttrc]
ccrctccrc	[clcctclcc,cclctcclc,crcctcrcc,ccrctccrc]
ccrctrrct	[ctllclcct,cclctllct,ctrrcrcct,ccrctrrct]
ccrrcllcc	[ccllcrrcc,ccrrcllcc,ccrrcllcc,ccllcrrcc]
ctctcrcrc	[ctctclclc,clclctctc,ctctcrcrc,crcrctctc]
cctcttcrc	[clcttctcc,cctcttclc,crcttctcc,cctcttcrc]
ccrctrrcr	[ctllclccr,cclctllcl,ctrrcrccl,ccrctrrcr]
ctctcrcrr	[ctctclcll,clctctcrr,ctctcrcrr,crctctcll]
ccrctrrcl	[ctllclccl,cclctllcr,ctrrcrccr,ccrctrrcl]
cctcttcrr	[cttctccll,cctcttcrr,cttctccrr,cctcttcll]
ccrrcllcl	[cllcrrccr,ccrrcllcl,crrcllccl,ccllcrrcr]
crclccllc	[cllcclcrc,crclccllc,crrccrclc,clcrccrrc]
ccrrcllct	[cllcrrcct,ccrrcllct,crrcllcct,ccllcrrct]
ccrrcllcr	[cllcrrccl,ccrrcllcr,crrcllccr,ccllcrrcl]
ccrcrrctc	[ctcllclcc,cclcllctc,ctcrrcrcc,ccrcrrctc]
ctrcrctlc	[ctlclctrc,ctrclctlc,ctrcrctlc,ctlcrctrc]
crcrrctrr	[cllclctrr,clcllctll,crrcrctll,crcrrctrr]
ccrcrrctt	[cllclcctt,cclcllctt,crrcrcctt,ccrcrrctt]
cctcctrrc	[ctllcctcc,cctcctllc,ctrrcctcc,cctcctrrc]
ccrcrrctr	[cllclcctr,cclcllctl,crrcrcctl,ccrcrrctr]
crcclctll	[clccrctrr,crcclctll,crcclctll,clccrctrr]
ccrcctllc	[ctllccrcc,ccrcctllc,ctrrcclcc,cclcctrrc]
ccrcrrctl	[cllclcctl,cclcllctr,crrcrcctr,ccrcrrctl]
ctrcrctll	[ctlclctrr,clctlctll,ctrcrctll,crctrctrr]
crcctclcl	[clctccrcr,crcctclcl,crctcclcl,clcctcrcr]
crcctclcr	[clctccrcl,crcctclcr,crctcclcr,clcctcrcl]
cttcrccrc	[cttclcclc,clcclcttc,cttcrccrc,crccrcttc]
crcctclct	[clctccrct,crcctclct,crctcclct,clcctcrct]
cttcrrrcr	[clllcttcr,cttclllcl,crrrcttcl,cttcrrrcr]
cttcrrrct	[clllcttct,cttclllct,crrrcttct,cttcrrrct]
cctrcrrrc	[clllctlcc,cctlclllc,crrrctrcc,cctrcrrrc]
cctrcttlc	[cttlctrcc,cctrcttlc,cttrctlcc,cctlcttrc]
cttcrrrcl	[clllcttcl,cttclllcr,crrrcttcr,cttcrrrcl]
ccrctllct	[ctllcrcct,ccrctllct,ctrrclcct,cclctrrct]
ccrrcrrcc	[ccllcllcc,ccllcllcc,ccrrcrrcc,ccrrcrrcc]
ccrrctttc	[ctttcllcc,ccllctttc,ctttcrrcc,ccrrctttc]
ctrctcllc	[ctlctcrrc,crrctctlc,ctrctcllc,cllctctrc]
cctcttctc	[ctcttctcc,cctcttctc,ctcttctcc,cctcttctc]
ctctcrclc	[ctctclcrc,crclctctc,ctctcrclc,clcrctctc]
ccrctllcr	[ctllcrccl,ccrctllcr,ctrrclccr,cclctrrcl]
ctctcrcll	[ctctclcrr,clctctcll,ctctcrcll,crctctcrr]
ccrctllcl	[ctllcrccr,ccrctllcl,ctrrclccl,cclctrrcr]
cctcttctr	[cttctcctl,cctcttctr,cttctcctr,cctcttctl]
crccrcllc	[cllcrccrc,crccrcllc,crrclcclc,clcclcrrc]
cctcttctt	[cttctcctt,cctcttctt,cttctcctt,cctcttctt]
ccrrcrrcr	[cllcllccr,ccllcllcl,crrcrrccl,ccrrcrrcr]
cttctcrrc	[cllctcttc,cttctcllc,crrctcttc,cttctcrrc]
ccrrcrrct	[cllcllcct,ccllcllct,crrcrrcct,ccrrcrrct]
crrclcrrc	[cllcrcllc,cllcrcllc,crrclcrrc,crrclcrrc]
ccrctcclc	[clcctcrcc,ccrctcclc,crcctclcc,cclctccrc]
ctccrcclc	[ctcclccrc,crcclcctc,ctccrcclc,clccrcctc]
ccrrcrrcl	[cllcllccl,ccllcllcr,crrcrrccr,ccrrcrrcl]
ccrccllcl	[cllccrccr,ccrccllcl,crrcclccl,cclccrrcr]
cttcrrctt	[cllcttctt,cttcllctt,crrcttctt,cttcrrctt]
ccrccllcc	[ccllccrcc,ccrccllcc,ccrrcclcc,cclccrrcc]
ccrccllct	[cllccrcct,ccrccllct,crrcclcct,cclccrrct]
ctcrrcclc	[ctcllccrc,crccllctc,ctcrrcclc,clccrrctc]
ccrccllcr	[cllccrccl,ccrccllcr,crrcclccr,cclccrrcl]
crcctcllc	[cllctccrc,crcctcllc,crrctcclc,clcctcrrc]
cttcrrctl	[cllcttctl,cttcllctr,crrcttctr,cttcrrctl]
cttcrrctr	[cllcttctr,cttcllctl,crrcttctl,cttcrrctr]
ccrccttrc	[cttlcclcc,cclccttlc,cttrccrcc,ccrccttrc]
ccrctrcrr	[ctlclccrr,cclctlcll,ctrcrccll,ccrctrcrr]
ctrctctrc	[ctlctctlc,ctlctctlc,ctrctctrc,ctrctctrc]
ccrrctlcl	[ctlcrrccr,ccrrctlcl,ctrcllccl,ccllctrcr]
ccrctrcrc	[clctlclcc,cclctlclc,crctrcrcc,ccrctrcrc]
ccrrctlcr	[ctlcrrccl,ccrrctlcr,ctrcllccr,ccllctrcl]
ccrrctlct	[ctlcrrcct,ccrrctlct,ctrcllcct,ccllctrct]
ccrccrrcr	[cllcclccr,cclccllcl,crrccrccl,ccrccrrcr]
ccrccrrct	[cllcclcct,cclccllct,crrccrcct,ccrccrrct]
ccrccrrcc	[ccllcclcc,cclccllcc,ccrrccrcc,ccrccrrcc]
ccrcctttc	[ctttcclcc,cclcctttc,ctttccrcc,ccrcctttc]
cttcrrcrr	[cllcttcrr,cttcllcll,crrcttcll,cttcrrcrr]
cctrccrrr	[cctlcclll,cctlccrrr,cctrccrrr,cctrcclll]
cttcrrcrc	[cttcllclc,clcllcttc,cttcrrcrc,crcrrcttc]
ccrccrrcl	[cllcclccl,cclccllcr,crrccrccr,ccrccrrcl]
cctrccrrc	[cllcctlcc,cctlccllc,crrcctrcc,cctrccrrc]
crctcrclc	[clctclcrc,crclctclc,crctcrclc,clcrctcrc]
crcrrclcr	[clcllcrcl,crcllclcr,crcrrclcr,clcrrcrcl]
crcrrclcl	[clcllcrcr,crcllclcl,crcrrclcl,clcrrcrcr]
crcrrclct	[clcllcrct,crcllclct,crcrrclct,clcrrcrct]
ccrctrcll	[ctlclccll,cclctlcrr,ctrcrccrr,ccrctrcll]
ccrrccrcl	[clccllccl,ccllcclcr,crccrrccr,ccrrccrcl]
ctccrrcll	[cllcctcll,ctccllcrr,crrcctcrr,ctccrrcll]
ctrcllctl	[ctlcrrctr,crrctlctl,ctrcllctl,cllctrctr]
ccrrccrct	[clccllcct,ccllcclct,crccrrcct,ccrrccrct]
ctrcllctr	[ctlcrrctl,crrctlctr,ctrcllctr,cllctrctl]
ccrctrclc	[clctrcrcc,ccrctrclc,crctlclcc,cclctlcrc]
ccrrccrcr	[clccllccr,ccllcclcl,crccrrccl,ccrrccrcr]
ctccrrclc	[ctccllcrc,crcllcctc,ctccrrclc,clcrrcctc]
ctrcllctt	[ctlcrrctt,crrctlctt,ctrcllctt,cllctrctt]
ctcrccrcl	[ctclcclcr,clcclctcl,ctcrccrcl,crccrctcr]
crrcrcrrc	[cllclcllc,cllclcllc,crrcrcrrc,crrcrcrrc]
ctcrccrcr	[ctclcclcl,clcclctcr,ctcrccrcr,crccrctcl]
cctcctctt	[ctcctcctt,cctcctctt,ctcctcctt,cctcctctt]
cctcctctc	[ctctcctcc,cctcctctc,ctctcctcc,cctcctctc]
crcrrcllc	[cllcrrcrc,crcrrcllc,crrcllclc,clcllcrrc]
cctrcttcr	[cttctlccr,cctlcttcl,cttctrccl,cctrcttcr]
cctrcttcl	[cttctlccl,cctlcttcr,cttctrccr,cctrcttcl]
cctrcttct	[cttctlcct,cctlcttct,cttctrcct,cctrcttct]
cctcctctr	[ctcctcctl,cctcctctr,ctcctcctr,cctcctctl]
ctcrccrct	[ctclcclct,clcclctct,ctcrccrct,crccrctct]
crcrrclll	[cllclclll,clcllcrrr,crrcrcrrr,crcrrclll]
crrclllct	[clllcrrct,crrclllct,crrrcllct,cllcrrrct]
crctcrcrr	[clctclcll,clctclcrr,crctcrcrr,crctcrcll]
crrclllcl	[clllcrrcr,crrclllcl,crrrcllcl,cllcrrrcr]
crccrctrr	[clcclctll,clcclctrr,crccrctrr,crccrctll]
crrclllcr	[clllcrrcl,crrclllcr,crrrcllcr,cllcrrrcl]
crctcrcrc	[clctclclc,clclctclc,crctcrcrc,crcrctcrc]
ctccrrcrc	[ctccllclc,clcllcctc,ctccrrcrc,crcrrcctc]
ctccrrcrr	[cllcctcrr,ctccllcll,crrcctcll,ctccrrcrr]
cttctttct	[ctttcttct,cttctttct,ctttcttct,cttctttct]
cttctttcr	[ctttcttcl,cttctttcr,ctttcttcr,cttctttcl]
cctcctcrc	[clctcctcc,cctcctclc,crctcctcc,cctcctcrc]
ctcrrccrc	[ctcllcclc,clccllctc,ctcrrccrc,crccrrctc]
cctcctcrr	[ctcctccll,cctcctcrr,ctcctccrr,cctcctcll]
cttrcclcl	[cttlccrcr,crccttlcl,cttrcclcl,clccttrcr]
cttrcclcr	[cttlccrcl,crccttlcr,cttrcclcr,clccttrcl]
cttrcclct	[cttlccrct,crccttlct,cttrcclct,clccttrct]
cctrctllc	[ctllctrcc,cctrctllc,ctrrctlcc,cctlctrrc]
ccrccrrrc	[clllcclcc,cclcclllc,crrrccrcc,ccrccrrrc]
ccrccttlc	[cttlccrcc,ccrccttlc,cttrcclcc,cclccttrc]
ccrctrctl	[ctlclcctl,cclctlctr,ctrcrcctr,ccrctrctl]
ccrctrctt	[ctlclcctt,cclctlctt,ctrcrcctt,ccrctrctt]
cttctccrc	[cttctcclc,clcctcttc,cttctccrc,crcctcttc]
ccrctrctr	[ctlclcctr,cclctlctl,ctrcrcctl,ccrctrctr]
ccrrccrrc	[cllccllcc,ccllccllc,crrccrrcc,ccrrccrrc]
ctccrrctl	[cllcctctl,ctccllctr,crrcctctr,ctccrrctl]
crctcrctt	[clctclctt,clctclctt,crctcrctt,crctcrctt]
crctcrctr	[clctclctl,clctclctr,crctcrctr,crctcrctl]
ctccrrctc	[ctcllcctc,ctccllctc,ctcrrcctc,ctccrrctc]
ctccrrctt	[cllcctctt,ctccllctt,crrcctctt,ctccrrctt]
ctccrrctr	[cllcctctr,ctccllctl,crrcctctl,ctccrrctr]
cttctrrct	[ctllcttct,cttctllct,ctrrcttct,cttctrrct]
ccrctrctc	[ctctlclcc,cclctlctc,ctctrcrcc,ccrctrctc]
ccrrccrrr	[ccllcclll,ccllccrrr,ccrrccrrr,ccrrcclll]
ctrctctlc	[ctlctctrc,ctrctctlc,ctrctctlc,ctlctctrc]
cttctrrcl	[ctllcttcl,cttctllcr,ctrrcttcr,cttctrrcl]
cttctrrcr	[ctllcttcr,cttctllcl,ctrrcttcl,cttctrrcr]
ctrcrrcrr	[ctlcllcll,cllctlcrr,ctrcrrcrr,crrctrcll]
cctcrcclc	[clccrctcc,cctcrcclc,crcclctcc,cctclccrc]
crccllctt	[cllccrctt,crccllctt,crrcclctt,clccrrctt]
cctcrccll	[cctclccrr,cclctccll,cctcrccll,ccrctccrr]
crccllctr	[cllccrctl,crccllctr,crrcclctr,clccrrctl]
ctcctrcll	[ctlcctcll,ctcctlcrr,ctrcctcrr,ctcctrcll]
crccllctl	[cllccrctr,crccllctl,crrcclctl,clccrrctr]
ctcctrclc	[ctcctlcrc,crctlcctc,ctcctrclc,clctrcctc]
ctrcrrcrc	[ctlcllclc,clcllctlc,ctrcrrcrc,crcrrctrc]
crctctclc	[clctctcrc,crctctclc,crctctclc,clctctcrc]
ccrctlcll	[ctlcrccrr,ccrctlcll,ctrclccll,cclctrcrr]
ccrctlclc	[clctlcrcc,ccrctlclc,crctrclcc,cclctrcrc]
ctrcrrctr	[ctlcllctl,cllctlctr,ctrcrrctr,crrctrctl]
ctrcrrctt	[ctlcllctt,cllctlctt,ctrcrrctt,crrctrctt]
ccrcctcll	[ctcclccll,cclcctcrr,ctccrccrr,ccrcctcll]
ctrcrrctl	[ctlcllctr,cllctlctl,ctrcrrctl,crrctrctr]
cctcrccrc	[clcclctcc,cctclcclc,crccrctcc,cctcrccrc]
crccllcrr	[cllccrcll,crccllcrr,crrcclcrr,clccrrcll]
cctcrccrr	[cctclccll,cclctccrr,cctcrccrr,ccrctccll]
cctcrrrct	[clllctcct,cctclllct,crrrctcct,cctcrrrct]
cctcrrrcc	[cclllctcc,cctclllcc,ccrrrctcc,cctcrrrcc]
ctrcctllc	[ctllcctrc,ctrcctllc,ctrrcctlc,ctlcctrrc]
cctcrrrcl	[clllctccl,cctclllcr,crrrctccr,cctcrrrcl]
cctcrrrcr	[clllctccr,cctclllcl,crrrctccl,cctcrrrcr]
ccrcctclc	[clctccrcc,ccrcctclc,crctcclcc,cclcctcrc]
crccllcrc	[clcrrcclc,clccrrclc,crcllccrc,crccllcrc]
ctrctllcr	[ctllctrcl,ctrctllcr,ctrrctlcr,ctlctrrcl]
ctrctllct	[ctllctrct,ctrctllct,ctrrctlct,ctlctrrct]
crrctcllc	[cllctcrrc,crrctcllc,crrctcllc,cllctcrrc]
ctrctllcl	[ctllctrcr,ctrctllcl,ctrrctlcl,ctlctrrcr]
crctctcrc	[clctctclc,clctctclc,crctctcrc,crctctcrc]
cctctcrrr	[ctctcclll,cctctcrrr,ctctccrrr,cctctclll]
cctctcrrc	[cllctctcc,cctctcllc,crrctctcc,cctctcrrc]
ccttctctt	[ctcttcctt,ccttctctt,ctcttcctt,ccttctctt]
ctrctcclc	[ctlctccrc,crcctctlc,ctrctcclc,clcctctrc]
ccttctctr	[ctcttcctl,ccttctctr,ctcttcctr,ccttctctl]
ccttctctc	[ctctcttcc,ccttctctc,ctctcttcc,ccttctctc]
ccrcclccr	[cclccrccl,ccrcclccr,ccrcclccr,cclccrccl]
ccrcclccl	[cclccrccr,ccrcclccl,ccrcclccl,cclccrccr]
ctcctrctr	[ctlcctctr,ctcctlctl,ctrcctctl,ctcctrctr]
cctcrcctc	[ctcclctcc,cctclcctc,ctccrctcc,cctcrcctc]
ctcctrctl	[ctlcctctl,ctcctlctr,ctrcctctr,ctcctrctl]
cctcrcctt	[cctclcctt,cclctcctt,cctcrcctt,ccrctcctt]
ctcctrctc	[ctctlcctc,ctcctlctc,ctctrcctc,ctcctrctc]
cctcrcctr	[cctclcctl,cclctcctr,cctcrcctr,ccrctcctl]
ccrcclcct	[cclccrcct,ccrcclcct,ccrcclcct,cclccrcct]
ctcctrctt	[ctlcctctt,ctcctlctt,ctrcctctt,ctcctrctt]
cctcrcctl	[cctclcctr,cclctcctl,cctcrcctl,ccrctcctr]
cttrctclc	[cttlctcrc,crctcttlc,cttrctclc,clctcttrc]
ccrctlctr	[ctlcrcctl,ccrctlctr,ctrclcctr,cclctrctl]
ccrctlctl	[ctlcrcctr,ccrctlctl,ctrclcctl,cclctrctr]
ccrrrctrc	[ctlclllcc,cclllctlc,ctrcrrrcc,ccrrrctrc]
ccrrrctrr	[clllcctrr,cclllctll,crrrcctll,ccrrrctrr]
ccttctcrr	[ctcttccll,ccttctcrr,ctcttccrr,ccttctcll]
ccrctlctc	[ctctlcrcc,ccrctlctc,ctctrclcc,cclctrctc]
ccrctlctt	[ctlcrcctt,ccrctlctt,ctrclcctt,cclctrctt]
ccttctcrc	[clctcttcc,ccttctclc,crctcttcc,ccttctcrc]
ctrcrrcll	[ctlcllcrr,cllctlcll,ctrcrrcll,crrctrcrr]
ctcrrcrrc	[cllcllctc,ctcllcllc,crrcrrctc,ctcrrcrrc]
ctrccrrct	[ctlccllct,cllcctlct,ctrccrrct,crrcctrct]
ctrccrrcl	[ctlccllcr,cllcctlcl,ctrccrrcl,crrcctrcr]
ctrccrrcr	[ctlccllcl,cllcctlcr,ctrccrrcr,crrcctrcl]
ctcctrcrr	[ctlcctcrr,ctcctlcll,ctrcctcll,ctcctrcrr]
cttcrclcr	[cttclcrcl,crclcttcr,cttcrclcr,clcrcttcl]
ctrcrrclc	[ctlcllcrc,crcllctlc,ctrcrrclc,clcrrctrc]
ctcctrcrc	[ctcctlclc,clctlcctc,ctcctrcrc,crctrcctc]
ctcrrcrrr	[cllctcrrr,ctcllclll,crrctclll,ctcrrcrrr]
cttcrclcl	[cttclcrcr,crclcttcl,cttcrclcl,clcrcttcr]
cttcrclct	[cttclcrct,crclcttct,cttcrclct,clcrcttct]
cttrctcrc	[cttlctclc,clctcttlc,cttrctcrc,crctcttrc]
ccrrrctlc	[ctlcrrrcc,ccrrrctlc,ctrclllcc,cclllctrc]
ccrrcclcr	[clccrrccl,ccrrcclcr,crccllccr,ccllccrcl]
cctctcrcc	[cctctclcc,cclctctcc,cctctcrcc,ccrctctcc]
ccrrcclcl	[clccrrccr,ccrrcclcl,crccllccl,ccllccrcr]
ccrrrctll	[clllcctll,cclllctrr,crrrcctrr,ccrrrctll]
crrrclllc	[clllcrrrc,crrrclllc,crrrclllc,clllcrrrc]
cctctcrcl	[clctctccl,cctctclcr,crctctccr,cctctcrcl]
ccrctlcrr	[ctlcrccll,ccrctlcrr,ctrclccrr,cclctrcll]
cctctcrct	[clctctcct,cctctclct,crctctcct,cctctcrct]
cctctcrcr	[clctctccr,cctctclcl,crctctccl,cctctcrcr]
ccrctlcrc	[clctrclcc,cclctrclc,crctlcrcc,ccrctlcrc]
ccrrcclct	[clccrrcct,ccrrcclct,crccllcct,ccllccrct]
ctrccllct	[ctlccrrct,crrcctlct,ctrccllct,cllcctrct]
crctttclc	[clctttcrc,crctttclc,crctttclc,clctttcrc]
cctcrrctc	[ctcllctcc,cctcllctc,ctcrrctcc,cctcrrctc]
ctrccllcl	[ctlccrrcr,crrcctlcl,ctrccllcl,cllcctrcr]
ctrccllcr	[ctlccrrcl,crrcctlcr,ctrccllcr,cllcctrcl]
cctcrrctr	[cllctcctr,cctcllctl,crrctcctl,cctcrrctr]
ccrcclcrc	[clcrcclcc,cclccrclc,crclccrcc,ccrcclcrc]
cttcrcttt	[cttclcttt,clcttcttt,cttcrcttt,crcttcttt]
cctcrrctt	[cllctcctt,cctcllctt,crrctcctt,cctcrrctt]
cctrcrctl	[clctlcctl,cctlclctr,crctrcctr,cctrcrctl]
cttcrcttr	[cttclcttl,clcttcttr,cttcrcttr,crcttcttl]
cctrcrctr	[clctlcctr,cctlclctl,crctrcctl,cctrcrctr]
ccrcclcrr	[clccrccll,ccrcclcrr,crcclccrr,cclccrcll]
cctcrrctl	[cllctcctl,cctcllctr,crrctcctr,cctcrrctl]
cctrcrctt	[clctlcctt,cctlclctt,crctrcctt,cctrcrctt]
cttcrcttc	[cttclcttc,cttclcttc,cttcrcttc,cttcrcttc]
cctrcrctc	[ctclctlcc,cctlclctc,ctcrctrcc,cctrcrctc]
crccttcrc	[clcttcclc,clccttclc,crcttccrc,crccttcrc]
cttcrcttl	[cttclcttr,clcttcttl,cttcrcttl,crcttcttr]
ccrrrctct	[ctclllcct,cclllctct,ctcrrrcct,ccrrrctct]
ccrrrctcr	[ctclllccr,cclllctcl,ctcrrrccl,ccrrrctcr]
ctrctrcrr	[ctlctlcll,ctlctlcrr,ctrctrcrr,ctrctrcll]
ccrrrctcl	[ctclllccl,cclllctcr,ctcrrrccr,ccrrrctcl]
ctrctrcrc	[ctlctlclc,clctlctlc,ctrctrcrc,crctrctrc]
ccrcclctl	[clccrcctr,ccrcclctl,crcclcctl,cclccrctr]
crctttcrc	[clctttclc,clctttclc,crctttcrc,crctttcrc]
cctcrrcct	[ccllctcct,cctcllcct,ccrrctcct,cctcrrcct]
cctrcrccl	[cctlclccr,cclctlccl,cctrcrccl,ccrctrccr]
cttcrctrr	[cttclctll,clcttctrr,cttcrctrr,crcttctll]
cctrcrccr	[cctlclccl,cclctlccr,cctrcrccr,ccrctrccl]
ccrcclctc	[ctclccrcc,ccrcclctc,ctcrcclcc,cclccrctc]
cctcrrccl	[ccllctccl,cctcllccr,ccrrctccr,cctcrrccl]
cctrcrcct	[cctlclcct,cclctlcct,cctrcrcct,ccrctrcct]
ccrcclctt	[clccrcctt,ccrcclctt,crcclcctt,cclccrctt]
cttcrctrc	[ctlclcttc,cttclctlc,ctrcrcttc,cttcrctrc]
cctcrrccr	[ccllctccr,cctcllccl,ccrrctccl,cctcrrccr]
ccrcclctr	[clccrcctl,ccrcclctr,crcclcctr,cclccrctl]
cttrcctrc	[cttlcctlc,ctlccttlc,cttrcctrc,ctrccttrc]
ctrccrrrc	[clllcctlc,ctlcclllc,crrrcctrc,ctrccrrrc]
cctrclllc	[clllctrcc,cctrclllc,crrrctlcc,cctlcrrrc]
ctcrrcrct	[ctcllclct,clcllctct,ctcrrcrct,crcrrctct]
ctcrrcrcl	[ctcllclcr,clcllctcl,ctcrrcrcl,crcrrctcr]
ctcrrcrcr	[ctcllclcl,clcllctcr,ctcrrcrcr,crcrrctcl]
ctrctrctr	[ctlctlctl,ctlctlctr,ctrctrctr,ctrctrctl]
cctctccrc	[clcctctcc,cctctcclc,crcctctcc,cctctccrc]
cttrctrct	[cttlctlct,ctlcttlct,cttrctrct,ctrcttrct]
cctctrrcr	[ctllctccr,cctctllcl,ctrrctccl,cctctrrcr]
cttrctrcr	[cttlctlcl,ctlcttlcr,cttrctrcr,ctrcttrcl]
cctctrrct	[ctllctcct,cctctllct,ctrrctcct,cctctrrct]
ccrrrcttc	[cttclllcc,cclllcttc,cttcrrrcc,ccrrrcttc]
cttrctrcl	[cttlctlcr,ctlcttlcl,cttrctrcl,ctrcttrcr]
cctctrrcc	[cctllctcc,cctctllcc,cctrrctcc,cctctrrcc]
ccrrrcttt	[clllccttt,cclllcttt,crrrccttt,ccrrrcttt]
cctctccrr	[cctctccll,cctctccrr,cctctccrr,cctctccll]
ccrrrcttr	[clllccttr,cclllcttl,crrrccttl,ccrrrcttr]
ccrrrcttl	[clllccttl,cclllcttr,crrrccttr,ccrrrcttl]
ctrctrctt	[ctlctlctt,ctlctlctt,ctrctrctt,ctrctrctt]
cctctrrcl	[ctllctccl,cctctllcr,ctrrctccr,cctctrrcl]
crccllcll	[cllccrcrr,crccllcll,crrcclcll,clccrrcrr]
cctrcrcll	[clctlccll,cctlclcrr,crctrccrr,cctrcrcll]
cttcrcllc	[cllcrcttc,cttcrcllc,crrclcttc,cttclcrrc]
cttrcctlc	[cttlcctrc,ctrccttlc,cttrcctlc,ctlccttrc]
cctrcrclc	[clcrctrcc,cctrcrclc,crclctlcc,cctlclcrc]
cttcrclll	[cttclcrrr,clcttclll,cttcrclll,crcttcrrr]
crccllclc	[clcllccrc,crccllclc,crcrrcclc,clccrrcrc]
cctctcctr	[cctctcctl,cctctcctr,cctctcctr,cctctcctl]
cctctttcr	[ctttctccl,cctctttcr,ctttctccr,cctctttcl]
cctctttct	[ctttctcct,cctctttct,ctttctcct,cctctttct]
cctctcctc	[ctcctctcc,cctctcctc,ctcctctcc,cctctcctc]
cctctttcc	[cctttctcc,cctctttcc,cctttctcc,cctctttcc]
cctctcctt	[cctctcctt,cctctcctt,cctctcctt,cctctcctt]
crrcllcrr	[cllcrrcll,crrcllcrr,crrcllcrr,cllcrrcll]
ctrcclllc	[clllcctrc,ctrcclllc,crrrcctlc,ctlccrrrc]
ccrcclcll	[clccrccrr,ccrcclcll,crcclccll,cclccrcrr]
cctrcrcrr	[clctlccrr,cctlclcll,crctrccll,cctrcrcrr]
cctrcrcrc	[clclctlcc,cctlclclc,crcrctrcc,cctrcrcrc]
crccttclc	[clcttccrc,crccttclc,crcttcclc,clccttcrc]
ccrcclclc	[clclccrcc,ccrcclclc,crcrcclcc,cclccrcrc]
crrcllctl	[cllcrrctr,crrcllctl,crrcllctl,cllcrrctr]
crrcllctr	[cllcrrctl,crrcllctr,crrcllctr,cllcrrctl]
cttrctrrc	[ctllcttlc,cttlctllc,ctrrcttrc,cttrctrrc]
ccrrrcllc	[cllcrrrcc,ccrrrcllc,crrclllcc,cclllcrrc]
ctctrcrct	[ctctlclct,clctlctct,ctctrcrct,crctrctct]
ctctrcrcr	[ctctlclcl,clctlctcr,ctctrcrcr,crctrctcl]
ccrrrclll	[clllcclll,cclllcrrr,crrrccrrr,ccrrrclll]
ctctrcrcl	[ctctlclcr,clctlctcl,ctctrcrcl,crctrctcr]
crrcllctt	[cllcrrctt,crrcllctt,crrcllctt,cllcrrctt]
ctrctrclc	[ctlctlcrc,crctlctlc,ctrctrclc,clctrctrc]
crcllcrcr	[clcrrclcl,clcrrclcr,crcllcrcr,crcllcrcl]
crcllcrct	[clcrrclct,clcrrclct,crcllcrct,crcllcrct]
ccrclcrcl	[clcrclccl,cclcrclcr,crclcrccr,ccrclcrcl]
ccrclcrcr	[clcrclccr,cclcrclcl,crclcrccl,ccrclcrcr]
ctrccrctl	[ctlcclctr,clcctlctl,ctrccrctl,crcctrctr]
ctrccrctr	[ctlcclctl,clcctlctr,ctrccrctr,crcctrctl]
ctrccrctt	[ctlcclctt,clcctlctt,ctrccrctt,crcctrctt]
crcrclllc	[clllcrcrc,crcrclllc,crrrclclc,clclcrrrc]
cctttcttr	[ctttccttl,cctttcttr,ctttccttr,cctttcttl]
cctttcttt	[ctttccttt,cctttcttt,ctttccttt,cctttcttt]
cttrclclc	[cttlcrcrc,crcrcttlc,cttrclclc,clclcttrc]
cctttcttc	[cttctttcc,cctttcttc,cttctttcc,cctttcttc]
cttrclcll	[cttlcrcrr,crcttlcll,cttrclcll,clcttrcrr]
ccrrrclct	[clcrrrcct,ccrrrclct,crclllcct,cclllcrct]
ccrrrclcr	[clcrrrccl,ccrrrclcr,crclllccr,cclllcrcl]
ccrrrclcl	[clcrrrccr,ccrrrclcl,crclllccl,cclllcrcr]
ctttcttrc	[cttlctttc,ctttcttlc,cttrctttc,ctttcttrc]
cctttctrc	[ctlctttcc,cctttctlc,ctrctttcc,cctttctrc]
cctrrclll	[ctllcclll,cctllcrrr,ctrrccrrr,cctrrclll]
cctrrcllc	[cllctrrcc,cctrrcllc,crrctllcc,cctllcrrc]
cttccrcll	[cttcclcrr,clccttcll,cttccrcll,crccttcrr]
cttccrclc	[cttcclcrc,crclccttc,cttccrclc,clcrccttc]
ctrccrcrc	[ctlcclclc,clclcctlc,ctrccrcrc,crcrcctrc]
crcrcrctr	[clclclctl,clclclctr,crcrcrctr,crcrcrctl]
crcrcrctt	[clclclctt,clclclctt,crcrcrctt,crcrcrctt]
ctrccrcrr	[ctlcclcll,clcctlcrr,ctrccrcrr,crcctrcll]
cctttctrr	[ctttcctll,cctttctrr,ctttcctrr,cctttctll]
cttrclcrc	[cttlcrclc,clcrcttlc,cttrclcrc,crclcttrc]
crcctlcrc	[clctrcclc,clcctrclc,crctlccrc,crcctlcrc]
crctccllc	[cllcctcrc,crctccllc,crrcctclc,clctccrrc]
ctttcrrcl	[cllctttcl,ctttcllcr,crrctttcr,ctttcrrcl]
ctrrclctl	[ctllcrctr,crctllctl,ctrrclctl,clctrrctr]
ctttcrrcr	[cllctttcr,ctttcllcl,crrctttcl,ctttcrrcr]
cttrclcrr	[cttlcrcll,crcttlcrr,cttrclcrr,clcttrcll]
ctrrclctr	[ctllcrctl,crctllctr,ctrrclctr,clctrrctl]
ctrrclctt	[ctllcrctt,crctllctt,ctrrclctt,clctrrctt]
ctctrcrrc	[cllctlctc,ctctlcllc,crrctrctc,ctctrcrrc]
ctctrcrrr	[ctlctcrrr,ctctlclll,ctrctclll,ctctrcrrr]
ccrclcrct	[clcrclcct,cclcrclct,crclcrcct,ccrclcrct]
ccrclcrcc	[cclcrclcc,cclcrclcc,ccrclcrcc,ccrclcrcc]
ctttcrrct	[cllctttct,ctttcllct,crrctttct,ctttcrrct]
ctttctttc	[ctttctttc,ctttctttc,ctttctttc,ctttctttc]
crrcllcll	[cllcrrcrr,crrcllcll,crrcllcll,cllcrrcrr]
cctrrclcc	[cctllcrcc,ccrctllcc,cctrrclcc,cclctrrcc]
cctrrclcl	[clctrrccr,cctrrclcl,crctllccl,cctllcrcr]
cctrrclct	[clctrrcct,cctrrclct,crctllcct,cctllcrct]
cctrrclcr	[clctrrccl,cctrrclcr,crctllccr,cctllcrcl]
crctlcllc	[cllctlcrc,crctlcllc,crrctrclc,clctrcrrc]
ctcttcrcr	[ctcttclcl,clcttctcr,ctcttcrcr,crcttctcl]
ctcttcrcl	[ctcttclcr,clcttctcl,ctcttcrcl,crcttctcr]
crcrcrcrr	[clclclcll,clclclcrr,crcrcrcrr,crcrcrcll]
ctcttcrct	[ctcttclct,clcttctct,ctcttcrct,crcttctct]
ctrccrcll	[ctlcclcrr,clcctlcll,ctrccrcll,crcctrcrr]
ctrccrclc	[ctlcclcrc,crclcctlc,ctrccrclc,clcrcctrc]
ctrrclcrr	[ctllcrcll,crctllcrr,ctrrclcrr,clctrrcll]
crcrcrcrc	[clclclclc,clclclclc,crcrcrcrc,crcrcrcrc]
ctrrclcrc	[ctllcrclc,clcrctllc,ctrrclcrc,crclctrrc]
ccttcctct	[ctccttcct,ccttcctct,ctccttcct,ccttcctct]
ccttcctcr	[ctccttccl,ccttcctcr,ctccttccr,ccttcctcl]
ctrrclcll	[ctllcrcrr,crctllcll,ctrrclcll,clctrrcrr]
crcrcrclc	[clclclcrc,crclclclc,crcrcrclc,clcrcrcrc]
ctrrclclc	[ctllcrcrc,crcrctllc,ctrrclclc,clclctrrc]
crctrclct	[clctlcrct,crctlclct,crctrclct,clctrcrct]
crctrclcr	[clctlcrcl,crctlclcr,crctrclcr,clctrcrcl]
crctrclcl	[clctlcrcr,crctlclcl,crctrclcl,clctrcrcr]
ctcttcrrc	[cllcttctc,ctcttcllc,crrcttctc,ctcttcrrc]
ccrcrcrcr	[clclclccr,cclclclcl,crcrcrccl,ccrcrcrcr]
ctcrclctr	[ctclcrctl,crclctctr,ctcrclctr,clcrctctl]
ccrcrcrct	[clclclcct,cclclclct,crcrcrcct,ccrcrcrct]
ctcrclctl	[ctclcrctr,crclctctl,ctcrclctl,clcrctctr]
ccrcrcrcc	[cclclclcc,cclclclcc,ccrcrcrcc,ccrcrcrcc]
ctcttcrrr	[cttctclll,ctcttcrrr,cttctcrrr,ctcttclll]
ctcrclctc	[ctclcrctc,ctcrclctc,ctcrclctc,ctclcrctc]
ctcrclctt	[ctclcrctt,crclctctt,ctcrclctt,clcrctctt]
crcrcrrcl	[cllclclcl,clclcllcr,crrcrcrcr,crcrcrrcl]
crcrcrrcr	[cllclclcr,clclcllcl,crrcrcrcl,crcrcrrcr]
crcrcrrct	[cllclclct,clclcllct,crrcrcrct,crcrcrrct]
ccttccttr	[ccttccttl,ccttccttr,ccttccttr,ccttccttl]
ccttctrcr	[ctlcttccr,ccttctlcl,ctrcttccl,ccttctrcr]
ccttccttt	[ccttccttt,ccttccttt,ccttccttt,ccttccttt]
ccttctrcl	[ctlcttccl,ccttctlcr,ctrcttccr,ccttctrcl]
ccttctrcc	[cctlcttcc,ccttctlcc,cctrcttcc,ccttctrcc]
ccttctrct	[ctlcttcct,ccttctlct,ctrcttcct,ccttctrct]
ctctrcclc	[ctctlccrc,crcctlctc,ctctrcclc,clcctrctc]
ctccrclcl	[ctcclcrcr,crclcctcl,ctccrclcl,clcrcctcr]
ctrrctcrc	[ctllctclc,clctctllc,ctrrctcrc,crctctrrc]
ctccrclcr	[ctcclcrcl,crclcctcr,ctccrclcr,clcrcctcl]
ctccrclct	[ctcclcrct,crclcctct,ctccrclct,clcrcctct]
ccrclcctr	[cclcrcctl,ccrclcctr,ccrclcctr,cclcrcctl]
ccrclcctt	[cclcrcctt,ccrclcctt,ccrclcctt,cclcrcctt]
ccrclcctl	[cclcrcctr,ccrclcctl,ccrclcctl,cclcrcctr]
ccttccttc	[cttccttcc,ccttccttc,cttccttcc,ccttccttc]
ccrclcctc	[ctcclcrcc,ccrclcctc,ctccrclcc,cclcrcctc]
crcttcllc	[cllcttcrc,crcttcllc,crrcttclc,clcttcrrc]
crcrcllct	[cllcrcrct,crcrcllct,crrclclct,clclcrrct]
crcrcllcr	[cllcrcrcl,crcrcllcr,crrclclcr,clclcrrcl]
crcrcllcl	[cllcrcrcr,crcrcllcl,crrclclcl,clclcrrcr]
cctcrcrrc	[cllclctcc,cctclcllc,crrcrctcc,cctcrcrrc]
cctcrcrrr	[clctccrrr,cctclclll,crctcclll,cctcrcrrr]
ccttcctrr	[ccttcctll,ccttcctrr,ccttcctrr,ccttcctll]
ctrrctclc	[ctllctcrc,crctctllc,ctrrctclc,clctctrrc]
ctctrccrc	[ctctlcclc,clcctlctc,ctctrccrc,crcctrctc]
ccrcrcrcl	[clclclccl,cclclclcr,crcrcrccr,ccrcrcrcl]
ctrclclct	[ctlcrcrct,crcrctlct,ctrclclct,clclctrct]
crrrcrrrc	[clllclllc,clllclllc,crrrcrrrc,crrrcrrrc]
ctttccrrc	[cllcctttc,ctttccllc,crrcctttc,ctttccrrc]
ccttcctrc	[ctlccttcc,ccttcctlc,ctrccttcc,ccttcctrc]
crcrcrrrc	[clllclclc,clclclllc,crrrcrcrc,crcrcrrrc]
ctcrclcll	[ctclcrcrr,crclctcll,ctcrclcll,clcrctcrr]
crcllcrrc	[cllcrrclc,clcrrcllc,crrcllcrc,crcllcrrc]
crcllcrrr	[cllcrclll,crcllcrrr,crrclcrrr,clcrrclll]
crcctlclc	[clctlccrc,crcctlclc,crctrcclc,clcctrcrc]
cttrclctr	[cttlcrctl,crcttlctr,cttrclctr,clcttrctl]
cttrclctt	[cttlcrctt,crcttlctt,cttrclctt,clcttrctt]
ctcrclclc	[ctclcrcrc,crcrclctc,ctcrclclc,clclcrctc]
crctrcllc	[cllctrcrc,crctrcllc,crrctlclc,clctlcrrc]
cttrclctl	[cttlcrctr,crcttlctl,cttrclctl,clcttrctr]
ccttctrrc	[ctllcttcc,ccttctllc,ctrrcttcc,ccttctrrc]
ctctccrct	[ctctcclct,clcctctct,ctctccrct,crcctctct]
ctctccrcr	[ctctcclcl,clcctctcr,ctctccrcr,crcctctcl]
ctctccrcl	[ctctcclcr,clcctctcl,ctctccrcl,crcctctcr]
ctcrclcrr	[ctclcrcll,crclctcrr,ctcrclcrr,clcrctcll]
cctcrcrct	[clclctcct,cctclclct,crcrctcct,cctcrcrct]
cctcrcrcc	[cctclclcc,cclclctcc,cctcrcrcc,ccrcrctcc]
cctcrcrcl	[clclctccl,cctclclcr,crcrctccr,cctcrcrcl]
cctcrcrcr	[clclctccr,cctclclcl,crcrctccl,cctcrcrcr]
ctttccrcr	[ctttcclcl,clcctttcr,ctttccrcr,crcctttcl]
ctttccrcl	[ctttcclcr,clcctttcl,ctttccrcl,crcctttcr]
ctttccrct	[ctttcclct,clcctttct,ctttccrct,crcctttct]
ctcrclcrc	[ctclcrclc,clcrclctc,ctcrclcrc,crclcrctc]
ccrclcrrc	[cllcrclcc,cclcrcllc,crrclcrcc,ccrclcrrc]
ccrclcrrr	[clcrcclll,ccrclcrrr,crclccrrr,cclcrclll]
